Pipeline	Screen	TP	FN	FN+FP	affected
val_AA10.6.NonSyn.02_batch1	3MCC	8	7	0	15
val_AA10.6.NonSyn.02_batch1	BKT	1	0	0	1
val_AA10.6.NonSyn.02_batch1	CIT	3	3	1	7
val_AA10.6.NonSyn.02_batch1	CTD	4	4	1	9
val_AA10.6.NonSyn.02_batch1	GA-I	1	0	0	1
val_AA10.6.NonSyn.02_batch1	GA2	3	1	0	4
val_AA10.6.NonSyn.02_batch1	HCY	0	1	0	1
val_AA10.6.NonSyn.02_batch1	IVA	1	1	1	3
val_AA10.6.NonSyn.02_batch1	MCAD	14	3	0	17
val_AA10.6.NonSyn.02_batch1	MCD	0	1	0	1
val_AA10.6.NonSyn.02_batch1	MSUD	1	1	1	3
val_AA10.6.NonSyn.02_batch1	OTC	3	2	0	5
val_AA10.6.NonSyn.02_batch1	PA/MMA	4	5	0	9
val_AA10.6.NonSyn.02_batch1	PKU	22	16	1	39
val_AA10.6.NonSyn.02_batch1	SCAD	8	9	0	17
val_AA10.6.NonSyn.02_batch1	TFP	0	1	0	1
val_AA10.6.NonSyn.02_batch1	VLCAD	2	3	0	5
val_AA10.5_filter1	3MCC	3	12	0	15
val_AA10.5_filter1	BKT	0	1	0	1
val_AA10.5_filter1	CIT	3	3	0	6
val_AA10.5_filter1	CTD	7	2	0	9
val_AA10.5_filter1	GA-I	0	1	0	1
val_AA10.5_filter1	GA2	2	2	0	4
val_AA10.5_filter1	HCY	1	0	0	1
val_AA10.5_filter1	IVA	3	0	0	3
val_AA10.5_filter1	MCAD	5	12	0	17
val_AA10.5_filter1	MCD	0	1	0	1
val_AA10.5_filter1	MSUD	1	2	0	3
val_AA10.5_filter1	OTC	2	3	0	5
val_AA10.5_filter1	PA/MMA	7	2	0	9
val_AA10.5_filter1	PKU	37	2	0	39
val_AA10.5_filter1	SCAD	6	11	0	17
val_AA10.5_filter1	TFP	0	1	0	1
val_AA10.5_filter1	VLCAD	3	2	0	5
AA10.6.NonSyn.02_filter2	3MCC	18	21	2	41
AA10.6.NonSyn.02_filter2	ARG	1	1	1	3
AA10.6.NonSyn.02_filter2	BKT	1	2	0	3
AA10.6.NonSyn.02_filter2	CIT	17	10	1	28
AA10.6.NonSyn.02_filter2	CPT I	0	1	0	1
AA10.6.NonSyn.02_filter2	CPT II	1	6	1	8
AA10.6.NonSyn.02_filter2	CTD	19	18	5	42
AA10.6.NonSyn.02_filter2	GA-I	20	10	1	31
AA10.6.NonSyn.02_filter2	GA2	7	4	0	11
AA10.6.NonSyn.02_filter2	HCY	4	4	2	10
AA10.6.NonSyn.02_filter2	HYPRO	0	2	0	2
AA10.6.NonSyn.02_filter2	IVA	17	14	3	34
AA10.6.NonSyn.02_filter2	LCHAD	2	6	1	9
AA10.6.NonSyn.02_filter2	MAL	1	5	0	6
AA10.6.NonSyn.02_filter2	MCAD	117	34	4	155
AA10.6.NonSyn.02_filter2	MCD	1	3	0	4
AA10.6.NonSyn.02_filter2	MSUD	13	10	2	25
AA10.6.NonSyn.02_filter2	OTC	9	5	0	14
AA10.6.NonSyn.02_filter2	PA/MMA	22	53	4	79
AA10.6.NonSyn.02_filter2	PKU	58	55	2	115
AA10.6.NonSyn.02_filter2	RMD	1	0	0	1
AA10.6.NonSyn.02_filter2	SCAD	31	42	4	77
AA10.6.NonSyn.02_filter2	TFP	1	3	0	4
AA10.6.NonSyn.02_filter2	TYRO1	3	3	0	6
AA10.6.NonSyn.02_filter2	VLCAD	21	20	0	41
test_AA10.3_filter2	3MCC	16	9	1	26
test_AA10.3_filter2	ARG	3	0	0	3
test_AA10.3_filter2	BKT	2	0	0	2
test_AA10.3_filter2	CIT	20	2	0	22
test_AA10.3_filter2	CPT I	1	0	0	1
test_AA10.3_filter2	CPT II	5	3	0	8
test_AA10.3_filter2	CTD	24	7	2	33
test_AA10.3_filter2	GA-I	26	4	0	30
test_AA10.3_filter2	GA2	6	1	0	7
test_AA10.3_filter2	HCY	7	1	1	9
test_AA10.3_filter2	HYPRO	0	2	0	2
test_AA10.3_filter2	IVA	24	6	1	31
test_AA10.3_filter2	LCHAD	9	0	0	9
test_AA10.3_filter2	MAL	2	4	0	6
test_AA10.3_filter2	MCAD	126	12	0	138
test_AA10.3_filter2	MCD	1	2	0	3
test_AA10.3_filter2	MSUD	19	3	0	22
test_AA10.3_filter2	OTC	8	1	0	9
test_AA10.3_filter2	PA/MMA	55	14	1	70
test_AA10.3_filter2	PKU	71	5	0	76
test_AA10.3_filter2	RMD	1	0	0	1
test_AA10.3_filter2	SCAD	28	29	3	60
test_AA10.3_filter2	TFP	3	0	0	3
test_AA10.3_filter2	TYRO1	6	0	0	6
test_AA10.3_filter2	VLCAD	30	6	0	36
AA10.4	3MCC	33	11	1	45
AA10.4	ARG	4	0	0	4
AA10.4	BKT	3	0	0	3
AA10.4	CIT	28	5	0	33
AA10.4	CPT I	1	0	0	1
AA10.4	CPT II	5	3	0	8
AA10.4	CTD	35	10	2	47
AA10.4	GA-I	31	4	1	36
AA10.4	GA2	9	3	0	12
AA10.4	HCY	6	4	2	12
AA10.4	HYPRO	0	3	0	3
AA10.4	IVA	34	5	1	40
AA10.4	LCHAD	9	0	0	9
AA10.4	MAL	2	4	0	6
AA10.4	MCAD	157	15	2	174
AA10.4	MCD	2	3	0	5
AA10.4	MSUD	21	3	1	25
AA10.4	OTC	13	3	0	16
AA10.4	PA/MMA	73	16	1	90
AA10.4	PKU	121	10	0	131
AA10.4	RMD	3	0	0	3
AA10.4	SCAD	40	42	2	84
AA10.4	TFP	4	0	0	4
AA10.4	TYRO1	7	0	0	7
AA10.4	VLCAD	38	9	0	47
test_AA10.6.NonSyn.01_filter1	3MCC	11	15	1	27
test_AA10.6.NonSyn.01_filter1	ARG	1	1	1	3
test_AA10.6.NonSyn.01_filter1	BKT	0	2	0	2
test_AA10.6.NonSyn.01_filter1	CIT	16	7	0	23
test_AA10.6.NonSyn.01_filter1	CPT I	0	1	0	1
test_AA10.6.NonSyn.01_filter1	CPT II	1	7	0	8
test_AA10.6.NonSyn.01_filter1	CTD	16	15	3	34
test_AA10.6.NonSyn.01_filter1	GA-I	20	11	0	31
test_AA10.6.NonSyn.01_filter1	GA2	4	3	0	7
test_AA10.6.NonSyn.01_filter1	HCY	5	3	2	10
test_AA10.6.NonSyn.01_filter1	HYPRO	0	2	0	2
test_AA10.6.NonSyn.01_filter1	IVA	18	13	2	33
test_AA10.6.NonSyn.01_filter1	LCHAD	2	6	1	9
test_AA10.6.NonSyn.01_filter1	MAL	1	5	0	6
test_AA10.6.NonSyn.01_filter1	MCAD	106	36	1	143
test_AA10.6.NonSyn.01_filter1	MCD	1	2	0	3
test_AA10.6.NonSyn.01_filter1	MSUD	12	9	1	22
test_AA10.6.NonSyn.01_filter1	OTC	6	3	0	9
test_AA10.6.NonSyn.01_filter1	PA/MMA	18	52	3	73
test_AA10.6.NonSyn.01_filter1	PKU	38	40	1	79
test_AA10.6.NonSyn.01_filter1	RMD	1	0	0	1
test_AA10.6.NonSyn.01_filter1	SCAD	23	37	3	63
test_AA10.6.NonSyn.01_filter1	TFP	1	2	0	3
test_AA10.6.NonSyn.01_filter1	TYRO1	3	4	0	7
test_AA10.6.NonSyn.01_filter1	VLCAD	21	18	0	39
AA10.4_filter1	3MCC	31	10	1	42
AA10.4_filter1	ARG	3	0	0	3
AA10.4_filter1	BKT	3	0	0	3
AA10.4_filter1	CIT	25	4	0	29
AA10.4_filter1	CPT I	1	0	0	1
AA10.4_filter1	CPT II	5	3	0	8
AA10.4_filter1	CTD	33	8	2	43
AA10.4_filter1	GA-I	28	4	0	32
AA10.4_filter1	GA2	9	2	0	11
AA10.4_filter1	HCY	6	3	2	11
AA10.4_filter1	HYPRO	0	2	0	2
AA10.4_filter1	IVA	30	5	1	36
AA10.4_filter1	LCHAD	9	0	0	9
AA10.4_filter1	MAL	2	4	0	6
AA10.4_filter1	MCAD	143	15	2	160
AA10.4_filter1	MCD	2	2	0	4
AA10.4_filter1	MSUD	21	3	1	25
AA10.4_filter1	OTC	12	2	0	14
AA10.4_filter1	PA/MMA	67	14	1	82
AA10.4_filter1	PKU	110	8	0	118
AA10.4_filter1	RMD	1	0	0	1
AA10.4_filter1	SCAD	40	38	2	80
AA10.4_filter1	TFP	4	0	0	4
AA10.4_filter1	TYRO1	7	0	0	7
AA10.4_filter1	VLCAD	35	9	0	44
AA10.3_filter3	3MCC	25	7	1	33
AA10.3_filter3	ARG	3	0	0	3
AA10.3_filter3	BKT	2	0	0	2
AA10.3_filter3	CIT	23	4	0	27
AA10.3_filter3	CPT I	1	0	0	1
AA10.3_filter3	CPT II	3	3	0	6
AA10.3_filter3	CTD	29	7	2	38
AA10.3_filter3	GA-I	24	4	0	28
AA10.3_filter3	GA2	8	1	0	9
AA10.3_filter3	HCY	7	1	1	9
AA10.3_filter3	HYPRO	0	2	0	2
AA10.3_filter3	IVA	21	7	1	29
AA10.3_filter3	LCHAD	7	0	0	7
AA10.3_filter3	MAL	2	4	0	6
AA10.3_filter3	MCAD	127	13	0	140
AA10.3_filter3	MCD	2	2	0	4
AA10.3_filter3	MSUD	17	3	0	20
AA10.3_filter3	OTC	8	1	0	9
AA10.3_filter3	PA/MMA	58	14	1	73
AA10.3_filter3	PKU	83	5	0	88
AA10.3_filter3	SCAD	33	32	2	67
AA10.3_filter3	TFP	4	0	0	4
AA10.3_filter3	TYRO1	6	0	0	6
AA10.3_filter3	VLCAD	33	6	0	39
test_AA10.2_filter3	3MCC	14	7	1	22
test_AA10.2_filter3	ARG	3	0	0	3
test_AA10.2_filter3	BKT	2	0	0	2
test_AA10.2_filter3	CIT	20	2	0	22
test_AA10.2_filter3	CPT I	1	0	0	1
test_AA10.2_filter3	CPT II	3	3	0	6
test_AA10.2_filter3	CTD	20	7	2	29
test_AA10.2_filter3	GA-I	23	4	0	27
test_AA10.2_filter3	GA2	6	1	0	7
test_AA10.2_filter3	HCY	6	1	1	8
test_AA10.2_filter3	HYPRO	0	2	0	2
test_AA10.2_filter3	IVA	22	4	1	27
test_AA10.2_filter3	LCHAD	7	0	0	7
test_AA10.2_filter3	MAL	2	4	0	6
test_AA10.2_filter3	MCAD	117	10	1	128
test_AA10.2_filter3	MCD	1	2	0	3
test_AA10.2_filter3	MSUD	17	1	0	18
test_AA10.2_filter3	OTC	6	0	0	6
test_AA10.2_filter3	PA/MMA	51	12	1	64
test_AA10.2_filter3	PKU	51	5	0	56
test_AA10.2_filter3	SCAD	25	25	2	52
test_AA10.2_filter3	TFP	3	0	0	3
test_AA10.2_filter3	TYRO1	6	0	0	6
test_AA10.2_filter3	VLCAD	29	6	0	35
val_AA10.6.NonSyn.01_filter2	3MCC	8	7	0	15
val_AA10.6.NonSyn.01_filter2	BKT	1	0	0	1
val_AA10.6.NonSyn.01_filter2	CIT	2	3	1	6
val_AA10.6.NonSyn.01_filter2	CTD	4	4	1	9
val_AA10.6.NonSyn.01_filter2	GA-I	1	0	0	1
val_AA10.6.NonSyn.01_filter2	GA2	3	1	0	4
val_AA10.6.NonSyn.01_filter2	HCY	0	1	0	1
val_AA10.6.NonSyn.01_filter2	IVA	1	2	0	3
val_AA10.6.NonSyn.01_filter2	MCAD	14	3	0	17
val_AA10.6.NonSyn.01_filter2	MCD	0	1	0	1
val_AA10.6.NonSyn.01_filter2	MSUD	1	1	1	3
val_AA10.6.NonSyn.01_filter2	OTC	3	2	0	5
val_AA10.6.NonSyn.01_filter2	PA/MMA	4	5	0	9
val_AA10.6.NonSyn.01_filter2	PKU	22	17	0	39
val_AA10.6.NonSyn.01_filter2	SCAD	8	9	0	17
val_AA10.6.NonSyn.01_filter2	TFP	0	1	0	1
val_AA10.6.NonSyn.01_filter2	VLCAD	2	3	0	5
AA10.6_filter1	3MCC	31	10	1	42
AA10.6_filter1	ARG	3	0	0	3
AA10.6_filter1	BKT	3	0	0	3
AA10.6_filter1	CIT	25	4	0	29
AA10.6_filter1	CPT I	1	0	0	1
AA10.6_filter1	CPT II	5	3	0	8
AA10.6_filter1	CTD	33	8	2	43
AA10.6_filter1	GA-I	28	4	0	32
AA10.6_filter1	GA2	9	2	0	11
AA10.6_filter1	HCY	6	3	2	11
AA10.6_filter1	HYPRO	0	2	0	2
AA10.6_filter1	IVA	27	8	1	36
AA10.6_filter1	LCHAD	9	0	0	9
AA10.6_filter1	MAL	2	4	0	6
AA10.6_filter1	MCAD	142	17	1	160
AA10.6_filter1	MCD	2	2	0	4
AA10.6_filter1	MSUD	19	4	2	25
AA10.6_filter1	OTC	11	3	0	14
AA10.6_filter1	PA/MMA	65	16	1	82
AA10.6_filter1	PKU	110	8	0	118
AA10.6_filter1	RMD	1	0	0	1
AA10.6_filter1	SCAD	40	38	2	80
AA10.6_filter1	TFP	4	0	0	4
AA10.6_filter1	TYRO1	7	0	0	7
AA10.6_filter1	VLCAD	35	9	0	44
val_AA10.1_batch1	3MCC	14	1	0	15
val_AA10.1_batch1	BKT	1	0	0	1
val_AA10.1_batch1	CIT	5	2	0	7
val_AA10.1_batch1	CTD	9	0	0	9
val_AA10.1_batch1	GA-I	1	0	0	1
val_AA10.1_batch1	GA2	3	1	0	4
val_AA10.1_batch1	HCY	1	0	0	1
val_AA10.1_batch1	IVA	3	0	0	3
val_AA10.1_batch1	MCAD	16	1	0	17
val_AA10.1_batch1	MCD	1	0	0	1
val_AA10.1_batch1	MSUD	2	1	0	3
val_AA10.1_batch1	OTC	4	1	0	5
val_AA10.1_batch1	PA/MMA	9	0	0	9
val_AA10.1_batch1	PKU	39	0	0	39
val_AA10.1_batch1	SCAD	9	8	0	17
val_AA10.1_batch1	TFP	1	0	0	1
val_AA10.1_batch1	VLCAD	5	0	0	5
test_AA10.8_filter2	3MCC	6	20	0	26
test_AA10.8_filter2	ARG	1	2	0	3
test_AA10.8_filter2	BKT	0	2	0	2
test_AA10.8_filter2	CIT	11	11	0	22
test_AA10.8_filter2	CPT I	1	0	0	1
test_AA10.8_filter2	CPT II	3	5	0	8
test_AA10.8_filter2	CTD	15	17	1	33
test_AA10.8_filter2	GA-I	16	14	0	30
test_AA10.8_filter2	GA2	3	4	0	7
test_AA10.8_filter2	HCY	2	6	1	9
test_AA10.8_filter2	HYPRO	0	2	0	2
test_AA10.8_filter2	IVA	12	18	1	31
test_AA10.8_filter2	LCHAD	5	4	0	9
test_AA10.8_filter2	MAL	1	5	0	6
test_AA10.8_filter2	MCAD	74	64	0	138
test_AA10.8_filter2	MCD	1	2	0	3
test_AA10.8_filter2	MSUD	8	14	0	22
test_AA10.8_filter2	OTC	7	2	0	9
test_AA10.8_filter2	PA/MMA	45	25	0	70
test_AA10.8_filter2	PKU	68	8	0	76
test_AA10.8_filter2	RMD	1	0	0	1
test_AA10.8_filter2	SCAD	5	55	0	60
test_AA10.8_filter2	TFP	1	2	0	3
test_AA10.8_filter2	TYRO1	5	1	0	6
test_AA10.8_filter2	VLCAD	18	18	0	36
val_AA10.6.NonSyn.02_filter4	3MCC	7	4	0	11
val_AA10.6.NonSyn.02_filter4	CIT	2	2	1	5
val_AA10.6.NonSyn.02_filter4	CTD	4	4	1	9
val_AA10.6.NonSyn.02_filter4	GA-I	1	0	0	1
val_AA10.6.NonSyn.02_filter4	GA2	2	0	0	2
val_AA10.6.NonSyn.02_filter4	HCY	0	1	0	1
val_AA10.6.NonSyn.02_filter4	IVA	0	1	1	2
val_AA10.6.NonSyn.02_filter4	MCAD	10	2	0	12
val_AA10.6.NonSyn.02_filter4	MCD	0	1	0	1
val_AA10.6.NonSyn.02_filter4	MSUD	1	1	0	2
val_AA10.6.NonSyn.02_filter4	OTC	2	1	0	3
val_AA10.6.NonSyn.02_filter4	PA/MMA	4	5	0	9
val_AA10.6.NonSyn.02_filter4	PKU	17	15	0	32
val_AA10.6.NonSyn.02_filter4	SCAD	7	8	0	15
val_AA10.6.NonSyn.02_filter4	TFP	0	1	0	1
val_AA10.6.NonSyn.02_filter4	VLCAD	2	2	0	4
AA10.8_filter4	3MCC	6	18	0	24
AA10.8_filter4	ARG	0	1	0	1
AA10.8_filter4	BKT	0	2	0	2
AA10.8_filter4	CIT	11	8	0	19
AA10.8_filter4	CPT II	2	4	0	6
AA10.8_filter4	CTD	16	16	1	33
AA10.8_filter4	GA-I	12	12	0	24
AA10.8_filter4	GA2	4	3	0	7
AA10.8_filter4	HCY	2	5	1	8
AA10.8_filter4	HYPRO	0	1	0	1
AA10.8_filter4	IVA	7	14	1	22
AA10.8_filter4	LCHAD	3	3	0	6
AA10.8_filter4	MAL	1	2	0	3
AA10.8_filter4	MCAD	56	53	0	109
AA10.8_filter4	MCD	1	3	0	4
AA10.8_filter4	MSUD	4	8	0	12
AA10.8_filter4	OTC	6	2	0	8
AA10.8_filter4	PA/MMA	36	25	0	61
AA10.8_filter4	PKU	48	9	0	57
AA10.8_filter4	SCAD	4	42	0	46
AA10.8_filter4	TFP	1	3	0	4
AA10.8_filter4	TYRO1	5	1	0	6
AA10.8_filter4	VLCAD	16	15	0	31
test_AA10.4_batch2	3MCC	6	6	1	13
test_AA10.4_batch2	ARG	2	0	0	2
test_AA10.4_batch2	CIT	7	2	0	9
test_AA10.4_batch2	CPT I	1	0	0	1
test_AA10.4_batch2	CPT II	0	1	0	1
test_AA10.4_batch2	CTD	7	1	0	8
test_AA10.4_batch2	GA-I	8	0	0	8
test_AA10.4_batch2	GA2	1	1	0	2
test_AA10.4_batch2	HCY	1	0	0	1
test_AA10.4_batch2	IVA	13	0	0	13
test_AA10.4_batch2	LCHAD	2	0	0	2
test_AA10.4_batch2	MAL	0	1	0	1
test_AA10.4_batch2	MCAD	39	1	0	40
test_AA10.4_batch2	MSUD	3	0	0	3
test_AA10.4_batch2	OTC	5	2	0	7
test_AA10.4_batch2	PA/MMA	13	1	0	14
test_AA10.4_batch2	PKU	59	2	0	61
test_AA10.4_batch2	RMD	3	0	0	3
test_AA10.4_batch2	SCAD	10	21	0	31
test_AA10.4_batch2	TFP	1	0	0	1
test_AA10.4_batch2	TYRO1	1	0	0	1
test_AA10.4_batch2	VLCAD	5	0	0	5
AA10.6_batch3	3MCC	13	4	0	17
AA10.6_batch3	ARG	2	0	0	2
AA10.6_batch3	BKT	2	0	0	2
AA10.6_batch3	CIT	16	1	0	17
AA10.6_batch3	CPT II	5	2	0	7
AA10.6_batch3	CTD	19	9	2	30
AA10.6_batch3	GA-I	22	4	1	27
AA10.6_batch3	GA2	5	1	0	6
AA10.6_batch3	HCY	5	3	2	10
AA10.6_batch3	HYPRO	0	3	0	3
AA10.6_batch3	IVA	17	6	1	24
AA10.6_batch3	LCHAD	7	0	0	7
AA10.6_batch3	MAL	2	3	0	5
AA10.6_batch3	MCAD	101	15	1	117
AA10.6_batch3	MCD	1	3	0	4
AA10.6_batch3	MSUD	15	3	1	19
AA10.6_batch3	OTC	4	0	0	4
AA10.6_batch3	PA/MMA	51	15	1	67
AA10.6_batch3	PKU	25	6	0	31
AA10.6_batch3	SCAD	21	13	2	36
AA10.6_batch3	TFP	2	0	0	2
AA10.6_batch3	TYRO1	6	0	0	6
AA10.6_batch3	VLCAD	29	8	0	37
AA10.4_batch1	3MCC	14	1	0	15
AA10.4_batch1	BKT	1	0	0	1
AA10.4_batch1	CIT	5	2	0	7
AA10.4_batch1	CTD	9	0	0	9
AA10.4_batch1	GA-I	1	0	0	1
AA10.4_batch1	GA2	3	1	0	4
AA10.4_batch1	HCY	0	1	0	1
AA10.4_batch1	IVA	3	0	0	3
AA10.4_batch1	MCAD	16	1	0	17
AA10.4_batch1	MCD	1	0	0	1
AA10.4_batch1	MSUD	1	1	1	3
AA10.4_batch1	OTC	4	1	0	5
AA10.4_batch1	PA/MMA	8	1	0	9
AA10.4_batch1	PKU	37	2	0	39
AA10.4_batch1	SCAD	9	8	0	17
AA10.4_batch1	TFP	1	0	0	1
AA10.4_batch1	VLCAD	4	1	0	5
val_AA10.4_filter1	3MCC	14	1	0	15
val_AA10.4_filter1	BKT	1	0	0	1
val_AA10.4_filter1	CIT	4	2	0	6
val_AA10.4_filter1	CTD	9	0	0	9
val_AA10.4_filter1	GA-I	1	0	0	1
val_AA10.4_filter1	GA2	3	1	0	4
val_AA10.4_filter1	HCY	0	1	0	1
val_AA10.4_filter1	IVA	3	0	0	3
val_AA10.4_filter1	MCAD	16	1	0	17
val_AA10.4_filter1	MCD	1	0	0	1
val_AA10.4_filter1	MSUD	1	1	1	3
val_AA10.4_filter1	OTC	4	1	0	5
val_AA10.4_filter1	PA/MMA	8	1	0	9
val_AA10.4_filter1	PKU	37	2	0	39
val_AA10.4_filter1	SCAD	9	8	0	17
val_AA10.4_filter1	TFP	1	0	0	1
val_AA10.4_filter1	VLCAD	4	1	0	5
test_AA10.4_filter1	3MCC	17	9	1	27
test_AA10.4_filter1	ARG	3	0	0	3
test_AA10.4_filter1	BKT	2	0	0	2
test_AA10.4_filter1	CIT	21	2	0	23
test_AA10.4_filter1	CPT I	1	0	0	1
test_AA10.4_filter1	CPT II	5	3	0	8
test_AA10.4_filter1	CTD	24	8	2	34
test_AA10.4_filter1	GA-I	27	4	0	31
test_AA10.4_filter1	GA2	6	1	0	7
test_AA10.4_filter1	HCY	6	2	2	10
test_AA10.4_filter1	HYPRO	0	2	0	2
test_AA10.4_filter1	IVA	27	5	1	33
test_AA10.4_filter1	LCHAD	9	0	0	9
test_AA10.4_filter1	MAL	2	4	0	6
test_AA10.4_filter1	MCAD	127	14	2	143
test_AA10.4_filter1	MCD	1	2	0	3
test_AA10.4_filter1	MSUD	20	2	0	22
test_AA10.4_filter1	OTC	8	1	0	9
test_AA10.4_filter1	PA/MMA	59	13	1	73
test_AA10.4_filter1	PKU	73	6	0	79
test_AA10.4_filter1	RMD	1	0	0	1
test_AA10.4_filter1	SCAD	31	30	2	63
test_AA10.4_filter1	TFP	3	0	0	3
test_AA10.4_filter1	TYRO1	7	0	0	7
test_AA10.4_filter1	VLCAD	31	8	0	39
AA10.1	3MCC	33	11	1	45
AA10.1	ARG	4	0	0	4
AA10.1	BKT	3	0	0	3
AA10.1	CIT	28	5	0	33
AA10.1	CPT I	1	0	0	1
AA10.1	CPT II	5	3	0	8
AA10.1	CTD	36	9	2	47
AA10.1	GA-I	31	4	1	36
AA10.1	GA2	9	3	0	12
AA10.1	HCY	9	2	1	12
AA10.1	HYPRO	0	3	0	3
AA10.1	IVA	34	5	1	40
AA10.1	LCHAD	9	0	0	9
AA10.1	MAL	2	4	0	6
AA10.1	MCAD	162	11	1	174
AA10.1	MCD	2	3	0	5
AA10.1	MSUD	21	4	0	25
AA10.1	OTC	13	3	0	16
AA10.1	PA/MMA	74	15	1	90
AA10.1	PKU	123	8	0	131
AA10.1	RMD	3	0	0	3
AA10.1	SCAD	40	41	3	84
AA10.1	TFP	4	0	0	4
AA10.1	TYRO1	7	0	0	7
AA10.1	VLCAD	41	6	0	47
val_AA10.5_filter2	3MCC	3	12	0	15
val_AA10.5_filter2	BKT	0	1	0	1
val_AA10.5_filter2	CIT	3	3	0	6
val_AA10.5_filter2	CTD	7	2	0	9
val_AA10.5_filter2	GA-I	0	1	0	1
val_AA10.5_filter2	GA2	2	2	0	4
val_AA10.5_filter2	HCY	1	0	0	1
val_AA10.5_filter2	IVA	3	0	0	3
val_AA10.5_filter2	MCAD	5	12	0	17
val_AA10.5_filter2	MCD	0	1	0	1
val_AA10.5_filter2	MSUD	1	2	0	3
val_AA10.5_filter2	OTC	2	3	0	5
val_AA10.5_filter2	PA/MMA	7	2	0	9
val_AA10.5_filter2	PKU	37	2	0	39
val_AA10.5_filter2	SCAD	6	11	0	17
val_AA10.5_filter2	TFP	0	1	0	1
val_AA10.5_filter2	VLCAD	3	2	0	5
test_AA10.6_filter4	3MCC	9	4	0	13
test_AA10.6_filter4	ARG	1	0	0	1
test_AA10.6_filter4	BKT	2	0	0	2
test_AA10.6_filter4	CIT	13	1	0	14
test_AA10.6_filter4	CPT II	3	3	0	6
test_AA10.6_filter4	CTD	15	7	2	24
test_AA10.6_filter4	GA-I	20	3	0	23
test_AA10.6_filter4	GA2	5	0	0	5
test_AA10.6_filter4	HCY	4	2	1	7
test_AA10.6_filter4	HYPRO	0	1	0	1
test_AA10.6_filter4	IVA	14	5	1	20
test_AA10.6_filter4	LCHAD	6	0	0	6
test_AA10.6_filter4	MAL	2	1	0	3
test_AA10.6_filter4	MCAD	83	13	1	97
test_AA10.6_filter4	MCD	1	2	0	3
test_AA10.6_filter4	MSUD	9	1	0	10
test_AA10.6_filter4	OTC	5	0	0	5
test_AA10.6_filter4	PA/MMA	40	11	1	52
test_AA10.6_filter4	PKU	21	4	0	25
test_AA10.6_filter4	SCAD	21	9	1	31
test_AA10.6_filter4	TFP	3	0	0	3
test_AA10.6_filter4	TYRO1	6	0	0	6
test_AA10.6_filter4	VLCAD	19	8	0	27
test_AA10.6.NonSyn.02	3MCC	13	15	2	30
test_AA10.6.NonSyn.02	ARG	1	2	1	4
test_AA10.6.NonSyn.02	BKT	0	2	0	2
test_AA10.6.NonSyn.02	CIT	16	9	1	26
test_AA10.6.NonSyn.02	CPT I	0	1	0	1
test_AA10.6.NonSyn.02	CPT II	1	6	1	8
test_AA10.6.NonSyn.02	CTD	18	16	4	38
test_AA10.6.NonSyn.02	GA-I	23	11	1	35
test_AA10.6.NonSyn.02	GA2	4	4	0	8
test_AA10.6.NonSyn.02	HCY	5	4	2	11
test_AA10.6.NonSyn.02	HYPRO	0	3	0	3
test_AA10.6.NonSyn.02	IVA	22	13	2	37
test_AA10.6.NonSyn.02	LCHAD	2	6	1	9
test_AA10.6.NonSyn.02	MAL	1	5	0	6
test_AA10.6.NonSyn.02	MCAD	118	35	4	157
test_AA10.6.NonSyn.02	MCD	1	3	0	4
test_AA10.6.NonSyn.02	MSUD	12	9	1	22
test_AA10.6.NonSyn.02	OTC	7	4	0	11
test_AA10.6.NonSyn.02	PA/MMA	20	56	5	81
test_AA10.6.NonSyn.02	PKU	43	47	2	92
test_AA10.6.NonSyn.02	RMD	1	2	0	3
test_AA10.6.NonSyn.02	SCAD	24	38	5	67
test_AA10.6.NonSyn.02	TFP	1	2	0	3
test_AA10.6.NonSyn.02	TYRO1	3	4	0	7
test_AA10.6.NonSyn.02	VLCAD	23	19	0	42
val_AA10.6.NonSyn.02_filter3	3MCC	7	4	0	11
val_AA10.6.NonSyn.02_filter3	CIT	2	2	1	5
val_AA10.6.NonSyn.02_filter3	CTD	4	4	1	9
val_AA10.6.NonSyn.02_filter3	GA-I	1	0	0	1
val_AA10.6.NonSyn.02_filter3	GA2	2	0	0	2
val_AA10.6.NonSyn.02_filter3	HCY	0	1	0	1
val_AA10.6.NonSyn.02_filter3	IVA	0	1	1	2
val_AA10.6.NonSyn.02_filter3	MCAD	10	2	0	12
val_AA10.6.NonSyn.02_filter3	MCD	0	1	0	1
val_AA10.6.NonSyn.02_filter3	MSUD	1	1	0	2
val_AA10.6.NonSyn.02_filter3	OTC	2	1	0	3
val_AA10.6.NonSyn.02_filter3	PA/MMA	4	5	0	9
val_AA10.6.NonSyn.02_filter3	PKU	17	15	0	32
val_AA10.6.NonSyn.02_filter3	SCAD	7	8	0	15
val_AA10.6.NonSyn.02_filter3	TFP	0	1	0	1
val_AA10.6.NonSyn.02_filter3	VLCAD	2	2	0	4
test_AA10.8	3MCC	8	22	0	30
test_AA10.8	ARG	2	2	0	4
test_AA10.8	BKT	0	2	0	2
test_AA10.8	CIT	14	12	0	26
test_AA10.8	CPT I	1	0	0	1
test_AA10.8	CPT II	3	5	0	8
test_AA10.8	CTD	15	22	1	38
test_AA10.8	GA-I	20	14	1	35
test_AA10.8	GA2	3	5	0	8
test_AA10.8	HCY	2	8	1	11
test_AA10.8	HYPRO	0	3	0	3
test_AA10.8	IVA	17	19	1	37
test_AA10.8	LCHAD	5	4	0	9
test_AA10.8	MAL	1	5	0	6
test_AA10.8	MCAD	84	73	0	157
test_AA10.8	MCD	1	3	0	4
test_AA10.8	MSUD	8	14	0	22
test_AA10.8	OTC	7	4	0	11
test_AA10.8	PA/MMA	52	29	0	81
test_AA10.8	PKU	81	11	0	92
test_AA10.8	RMD	3	0	0	3
test_AA10.8	SCAD	6	61	0	67
test_AA10.8	TFP	1	2	0	3
test_AA10.8	TYRO1	6	1	0	7
test_AA10.8	VLCAD	20	22	0	42
AA10.6_filter4	3MCC	20	4	0	24
AA10.6_filter4	ARG	1	0	0	1
AA10.6_filter4	BKT	2	0	0	2
AA10.6_filter4	CIT	16	3	0	19
AA10.6_filter4	CPT II	3	3	0	6
AA10.6_filter4	CTD	24	7	2	33
AA10.6_filter4	GA-I	21	3	0	24
AA10.6_filter4	GA2	7	0	0	7
AA10.6_filter4	HCY	4	3	1	8
AA10.6_filter4	HYPRO	0	1	0	1
AA10.6_filter4	IVA	14	7	1	22
AA10.6_filter4	LCHAD	6	0	0	6
AA10.6_filter4	MAL	2	1	0	3
AA10.6_filter4	MCAD	94	14	1	109
AA10.6_filter4	MCD	2	2	0	4
AA10.6_filter4	MSUD	10	2	0	12
AA10.6_filter4	OTC	7	1	0	8
AA10.6_filter4	PA/MMA	47	13	1	61
AA10.6_filter4	PKU	52	5	0	57
AA10.6_filter4	SCAD	29	16	1	46
AA10.6_filter4	TFP	4	0	0	4
AA10.6_filter4	TYRO1	6	0	0	6
AA10.6_filter4	VLCAD	23	8	0	31
test_AA10.3_batch2	3MCC	6	6	1	13
test_AA10.3_batch2	ARG	2	0	0	2
test_AA10.3_batch2	CIT	7	2	0	9
test_AA10.3_batch2	CPT I	1	0	0	1
test_AA10.3_batch2	CPT II	0	1	0	1
test_AA10.3_batch2	CTD	7	1	0	8
test_AA10.3_batch2	GA-I	8	0	0	8
test_AA10.3_batch2	GA2	1	1	0	2
test_AA10.3_batch2	HCY	1	0	0	1
test_AA10.3_batch2	IVA	13	0	0	13
test_AA10.3_batch2	LCHAD	2	0	0	2
test_AA10.3_batch2	MAL	0	1	0	1
test_AA10.3_batch2	MCAD	40	0	0	40
test_AA10.3_batch2	MSUD	3	0	0	3
test_AA10.3_batch2	OTC	5	2	0	7
test_AA10.3_batch2	PA/MMA	13	1	0	14
test_AA10.3_batch2	PKU	59	2	0	61
test_AA10.3_batch2	RMD	3	0	0	3
test_AA10.3_batch2	SCAD	9	21	1	31
test_AA10.3_batch2	TFP	1	0	0	1
test_AA10.3_batch2	TYRO1	1	0	0	1
test_AA10.3_batch2	VLCAD	5	0	0	5
AA10.6.NonSyn.005_filter4	3MCC	10	14	0	24
AA10.6.NonSyn.005_filter4	ARG	1	0	0	1
AA10.6.NonSyn.005_filter4	BKT	0	2	0	2
AA10.6.NonSyn.005_filter4	CIT	11	7	1	19
AA10.6.NonSyn.005_filter4	CPT II	1	5	0	6
AA10.6.NonSyn.005_filter4	CTD	13	17	3	33
AA10.6.NonSyn.005_filter4	GA-I	15	9	0	24
AA10.6.NonSyn.005_filter4	GA2	5	2	0	7
AA10.6.NonSyn.005_filter4	HCY	3	4	1	8
AA10.6.NonSyn.005_filter4	HYPRO	0	1	0	1
AA10.6.NonSyn.005_filter4	IVA	8	13	1	22
AA10.6.NonSyn.005_filter4	LCHAD	2	4	0	6
AA10.6.NonSyn.005_filter4	MAL	1	2	0	3
AA10.6.NonSyn.005_filter4	MCAD	81	27	1	109
AA10.6.NonSyn.005_filter4	MCD	1	3	0	4
AA10.6.NonSyn.005_filter4	MSUD	7	5	0	12
AA10.6.NonSyn.005_filter4	OTC	6	2	0	8
AA10.6.NonSyn.005_filter4	PA/MMA	14	45	2	61
AA10.6.NonSyn.005_filter4	PKU	31	26	0	57
AA10.6.NonSyn.005_filter4	SCAD	24	21	1	46
AA10.6.NonSyn.005_filter4	TFP	1	3	0	4
AA10.6.NonSyn.005_filter4	TYRO1	3	3	0	6
AA10.6.NonSyn.005_filter4	VLCAD	16	15	0	31
AA10.6.NonSyn.005_batch1	3MCC	8	7	0	15
AA10.6.NonSyn.005_batch1	BKT	1	0	0	1
AA10.6.NonSyn.005_batch1	CIT	3	3	1	7
AA10.6.NonSyn.005_batch1	CTD	4	4	1	9
AA10.6.NonSyn.005_batch1	GA-I	1	0	0	1
AA10.6.NonSyn.005_batch1	GA2	3	1	0	4
AA10.6.NonSyn.005_batch1	HCY	0	1	0	1
AA10.6.NonSyn.005_batch1	IVA	1	2	0	3
AA10.6.NonSyn.005_batch1	MCAD	14	3	0	17
AA10.6.NonSyn.005_batch1	MCD	0	1	0	1
AA10.6.NonSyn.005_batch1	MSUD	1	1	1	3
AA10.6.NonSyn.005_batch1	OTC	3	2	0	5
AA10.6.NonSyn.005_batch1	PA/MMA	3	6	0	9
AA10.6.NonSyn.005_batch1	PKU	22	17	0	39
AA10.6.NonSyn.005_batch1	SCAD	8	9	0	17
AA10.6.NonSyn.005_batch1	TFP	0	1	0	1
AA10.6.NonSyn.005_batch1	VLCAD	2	3	0	5
AA10.1_filter2	3MCC	30	10	1	41
AA10.1_filter2	ARG	3	0	0	3
AA10.1_filter2	BKT	3	0	0	3
AA10.1_filter2	CIT	24	4	0	28
AA10.1_filter2	CPT I	1	0	0	1
AA10.1_filter2	CPT II	5	3	0	8
AA10.1_filter2	CTD	33	7	2	42
AA10.1_filter2	GA-I	27	4	0	31
AA10.1_filter2	GA2	9	2	0	11
AA10.1_filter2	HCY	8	1	1	10
AA10.1_filter2	HYPRO	0	2	0	2
AA10.1_filter2	IVA	28	5	1	34
AA10.1_filter2	LCHAD	9	0	0	9
AA10.1_filter2	MAL	2	4	0	6
AA10.1_filter2	MCAD	143	11	1	155
AA10.1_filter2	MCD	2	2	0	4
AA10.1_filter2	MSUD	21	4	0	25
AA10.1_filter2	OTC	12	2	0	14
AA10.1_filter2	PA/MMA	65	13	1	79
AA10.1_filter2	PKU	110	5	0	115
AA10.1_filter2	RMD	1	0	0	1
AA10.1_filter2	SCAD	37	37	3	77
AA10.1_filter2	TFP	4	0	0	4
AA10.1_filter2	TYRO1	6	0	0	6
AA10.1_filter2	VLCAD	35	6	0	41
val_AA10.3_filter4	3MCC	11	0	0	11
val_AA10.3_filter4	CIT	3	2	0	5
val_AA10.3_filter4	CTD	9	0	0	9
val_AA10.3_filter4	GA-I	1	0	0	1
val_AA10.3_filter4	GA2	2	0	0	2
val_AA10.3_filter4	HCY	1	0	0	1
val_AA10.3_filter4	IVA	0	2	0	2
val_AA10.3_filter4	MCAD	11	1	0	12
val_AA10.3_filter4	MCD	1	0	0	1
val_AA10.3_filter4	MSUD	1	1	0	2
val_AA10.3_filter4	OTC	2	1	0	3
val_AA10.3_filter4	PA/MMA	8	1	0	9
val_AA10.3_filter4	PKU	32	0	0	32
val_AA10.3_filter4	SCAD	8	7	0	15
val_AA10.3_filter4	TFP	1	0	0	1
val_AA10.3_filter4	VLCAD	4	0	0	4
val_AA10.7_filter4	3MCC	3	8	0	11
val_AA10.7_filter4	CIT	3	2	0	5
val_AA10.7_filter4	CTD	7	2	0	9
val_AA10.7_filter4	GA-I	0	1	0	1
val_AA10.7_filter4	GA2	1	1	0	2
val_AA10.7_filter4	HCY	1	0	0	1
val_AA10.7_filter4	IVA	0	2	0	2
val_AA10.7_filter4	MCAD	4	8	0	12
val_AA10.7_filter4	MCD	0	1	0	1
val_AA10.7_filter4	MSUD	0	2	0	2
val_AA10.7_filter4	OTC	1	2	0	3
val_AA10.7_filter4	PA/MMA	6	3	0	9
val_AA10.7_filter4	PKU	30	2	0	32
val_AA10.7_filter4	SCAD	5	10	0	15
val_AA10.7_filter4	TFP	0	1	0	1
val_AA10.7_filter4	VLCAD	2	2	0	4
AA10.6.NonSyn.005_filter3	3MCC	15	17	1	33
AA10.6.NonSyn.005_filter3	ARG	1	1	1	3
AA10.6.NonSyn.005_filter3	BKT	0	2	0	2
AA10.6.NonSyn.005_filter3	CIT	17	9	1	27
AA10.6.NonSyn.005_filter3	CPT I	0	1	0	1
AA10.6.NonSyn.005_filter3	CPT II	1	5	0	6
AA10.6.NonSyn.005_filter3	CTD	16	19	3	38
AA10.6.NonSyn.005_filter3	GA-I	17	11	0	28
AA10.6.NonSyn.005_filter3	GA2	6	3	0	9
AA10.6.NonSyn.005_filter3	HCY	4	4	1	9
AA10.6.NonSyn.005_filter3	HYPRO	0	2	0	2
AA10.6.NonSyn.005_filter3	IVA	13	14	2	29
AA10.6.NonSyn.005_filter3	LCHAD	2	5	0	7
AA10.6.NonSyn.005_filter3	MAL	1	5	0	6
AA10.6.NonSyn.005_filter3	MCAD	105	34	1	140
AA10.6.NonSyn.005_filter3	MCD	1	3	0	4
AA10.6.NonSyn.005_filter3	MSUD	12	8	0	20
AA10.6.NonSyn.005_filter3	OTC	7	2	0	9
AA10.6.NonSyn.005_filter3	PA/MMA	18	53	2	73
AA10.6.NonSyn.005_filter3	PKU	44	43	1	88
AA10.6.NonSyn.005_filter3	SCAD	27	39	1	67
AA10.6.NonSyn.005_filter3	TFP	1	3	0	4
AA10.6.NonSyn.005_filter3	TYRO1	3	3	0	6
AA10.6.NonSyn.005_filter3	VLCAD	20	19	0	39
val_AA10.3_filter1	3MCC	14	1	0	15
val_AA10.3_filter1	BKT	1	0	0	1
val_AA10.3_filter1	CIT	4	2	0	6
val_AA10.3_filter1	CTD	9	0	0	9
val_AA10.3_filter1	GA-I	1	0	0	1
val_AA10.3_filter1	GA2	3	1	0	4
val_AA10.3_filter1	HCY	1	0	0	1
val_AA10.3_filter1	IVA	1	2	0	3
val_AA10.3_filter1	MCAD	16	1	0	17
val_AA10.3_filter1	MCD	1	0	0	1
val_AA10.3_filter1	MSUD	2	1	0	3
val_AA10.3_filter1	OTC	3	2	0	5
val_AA10.3_filter1	PA/MMA	8	1	0	9
val_AA10.3_filter1	PKU	39	0	0	39
val_AA10.3_filter1	SCAD	9	8	0	17
val_AA10.3_filter1	TFP	1	0	0	1
val_AA10.3_filter1	VLCAD	5	0	0	5
AA10.5_filter2	3MCC	9	32	0	41
AA10.5_filter2	ARG	1	2	0	3
AA10.5_filter2	BKT	0	3	0	3
AA10.5_filter2	CIT	14	14	0	28
AA10.5_filter2	CPT I	1	0	0	1
AA10.5_filter2	CPT II	3	5	0	8
AA10.5_filter2	CTD	22	18	2	42
AA10.5_filter2	GA-I	16	15	0	31
AA10.5_filter2	GA2	5	6	0	11
AA10.5_filter2	HCY	5	4	1	10
AA10.5_filter2	HYPRO	0	2	0	2
AA10.5_filter2	IVA	16	16	2	34
AA10.5_filter2	LCHAD	5	4	0	9
AA10.5_filter2	MAL	1	5	0	6
AA10.5_filter2	MCAD	81	71	3	155
AA10.5_filter2	MCD	1	3	0	4
AA10.5_filter2	MSUD	11	14	0	25
AA10.5_filter2	OTC	9	5	0	14
AA10.5_filter2	PA/MMA	54	25	0	79
AA10.5_filter2	PKU	107	8	0	115
AA10.5_filter2	RMD	1	0	0	1
AA10.5_filter2	SCAD	20	55	2	77
AA10.5_filter2	TFP	1	3	0	4
AA10.5_filter2	TYRO1	5	1	0	6
AA10.5_filter2	VLCAD	21	20	0	41
AA10.4_batch3	3MCC	13	4	0	17
AA10.4_batch3	ARG	2	0	0	2
AA10.4_batch3	BKT	2	0	0	2
AA10.4_batch3	CIT	16	1	0	17
AA10.4_batch3	CPT II	5	2	0	7
AA10.4_batch3	CTD	19	9	2	30
AA10.4_batch3	GA-I	22	4	1	27
AA10.4_batch3	GA2	5	1	0	6
AA10.4_batch3	HCY	5	3	2	10
AA10.4_batch3	HYPRO	0	3	0	3
AA10.4_batch3	IVA	18	5	1	24
AA10.4_batch3	LCHAD	7	0	0	7
AA10.4_batch3	MAL	2	3	0	5
AA10.4_batch3	MCAD	102	13	2	117
AA10.4_batch3	MCD	1	3	0	4
AA10.4_batch3	MSUD	17	2	0	19
AA10.4_batch3	OTC	4	0	0	4
AA10.4_batch3	PA/MMA	52	14	1	67
AA10.4_batch3	PKU	25	6	0	31
AA10.4_batch3	SCAD	21	13	2	36
AA10.4_batch3	TFP	2	0	0	2
AA10.4_batch3	TYRO1	6	0	0	6
AA10.4_batch3	VLCAD	29	8	0	37
test_AA10.1_filter3	3MCC	14	7	1	22
test_AA10.1_filter3	ARG	3	0	0	3
test_AA10.1_filter3	BKT	2	0	0	2
test_AA10.1_filter3	CIT	20	2	0	22
test_AA10.1_filter3	CPT I	1	0	0	1
test_AA10.1_filter3	CPT II	3	3	0	6
test_AA10.1_filter3	CTD	20	7	2	29
test_AA10.1_filter3	GA-I	23	4	0	27
test_AA10.1_filter3	GA2	6	1	0	7
test_AA10.1_filter3	HCY	6	1	1	8
test_AA10.1_filter3	HYPRO	0	2	0	2
test_AA10.1_filter3	IVA	22	4	1	27
test_AA10.1_filter3	LCHAD	7	0	0	7
test_AA10.1_filter3	MAL	2	4	0	6
test_AA10.1_filter3	MCAD	117	10	1	128
test_AA10.1_filter3	MCD	1	2	0	3
test_AA10.1_filter3	MSUD	16	2	0	18
test_AA10.1_filter3	OTC	6	0	0	6
test_AA10.1_filter3	PA/MMA	51	12	1	64
test_AA10.1_filter3	PKU	51	5	0	56
test_AA10.1_filter3	SCAD	25	25	2	52
test_AA10.1_filter3	TFP	3	0	0	3
test_AA10.1_filter3	TYRO1	6	0	0	6
test_AA10.1_filter3	VLCAD	29	6	0	35
val_AA10.6_filter2	3MCC	14	1	0	15
val_AA10.6_filter2	BKT	1	0	0	1
val_AA10.6_filter2	CIT	4	2	0	6
val_AA10.6_filter2	CTD	9	0	0	9
val_AA10.6_filter2	GA-I	1	0	0	1
val_AA10.6_filter2	GA2	3	1	0	4
val_AA10.6_filter2	HCY	0	1	0	1
val_AA10.6_filter2	IVA	1	2	0	3
val_AA10.6_filter2	MCAD	16	1	0	17
val_AA10.6_filter2	MCD	1	0	0	1
val_AA10.6_filter2	MSUD	1	1	1	3
val_AA10.6_filter2	OTC	3	2	0	5
val_AA10.6_filter2	PA/MMA	7	2	0	9
val_AA10.6_filter2	PKU	37	2	0	39
val_AA10.6_filter2	SCAD	9	8	0	17
val_AA10.6_filter2	TFP	1	0	0	1
val_AA10.6_filter2	VLCAD	4	1	0	5
val_AA10.6_filter1	3MCC	14	1	0	15
val_AA10.6_filter1	BKT	1	0	0	1
val_AA10.6_filter1	CIT	4	2	0	6
val_AA10.6_filter1	CTD	9	0	0	9
val_AA10.6_filter1	GA-I	1	0	0	1
val_AA10.6_filter1	GA2	3	1	0	4
val_AA10.6_filter1	HCY	0	1	0	1
val_AA10.6_filter1	IVA	1	2	0	3
val_AA10.6_filter1	MCAD	16	1	0	17
val_AA10.6_filter1	MCD	1	0	0	1
val_AA10.6_filter1	MSUD	1	1	1	3
val_AA10.6_filter1	OTC	3	2	0	5
val_AA10.6_filter1	PA/MMA	7	2	0	9
val_AA10.6_filter1	PKU	37	2	0	39
val_AA10.6_filter1	SCAD	9	8	0	17
val_AA10.6_filter1	TFP	1	0	0	1
val_AA10.6_filter1	VLCAD	4	1	0	5
test_AA10.6.NonSyn.01_filter4	3MCC	3	10	0	13
test_AA10.6.NonSyn.01_filter4	ARG	1	0	0	1
test_AA10.6.NonSyn.01_filter4	BKT	0	2	0	2
test_AA10.6.NonSyn.01_filter4	CIT	9	5	0	14
test_AA10.6.NonSyn.01_filter4	CPT II	1	5	0	6
test_AA10.6.NonSyn.01_filter4	CTD	9	12	3	24
test_AA10.6.NonSyn.01_filter4	GA-I	14	9	0	23
test_AA10.6.NonSyn.01_filter4	GA2	3	2	0	5
test_AA10.6.NonSyn.01_filter4	HCY	3	3	1	7
test_AA10.6.NonSyn.01_filter4	HYPRO	0	1	0	1
test_AA10.6.NonSyn.01_filter4	IVA	8	11	1	20
test_AA10.6.NonSyn.01_filter4	LCHAD	2	3	1	6
test_AA10.6.NonSyn.01_filter4	MAL	1	2	0	3
test_AA10.6.NonSyn.01_filter4	MCAD	71	25	1	97
test_AA10.6.NonSyn.01_filter4	MCD	1	2	0	3
test_AA10.6.NonSyn.01_filter4	MSUD	6	4	0	10
test_AA10.6.NonSyn.01_filter4	OTC	4	1	0	5
test_AA10.6.NonSyn.01_filter4	PA/MMA	12	38	2	52
test_AA10.6.NonSyn.01_filter4	PKU	14	11	0	25
test_AA10.6.NonSyn.01_filter4	SCAD	17	12	2	31
test_AA10.6.NonSyn.01_filter4	TFP	1	2	0	3
test_AA10.6.NonSyn.01_filter4	TYRO1	3	3	0	6
test_AA10.6.NonSyn.01_filter4	VLCAD	14	13	0	27
val_AA10.5_filter3	3MCC	3	8	0	11
val_AA10.5_filter3	CIT	3	2	0	5
val_AA10.5_filter3	CTD	7	2	0	9
val_AA10.5_filter3	GA-I	0	1	0	1
val_AA10.5_filter3	GA2	1	1	0	2
val_AA10.5_filter3	HCY	1	0	0	1
val_AA10.5_filter3	IVA	2	0	0	2
val_AA10.5_filter3	MCAD	4	8	0	12
val_AA10.5_filter3	MCD	0	1	0	1
val_AA10.5_filter3	MSUD	0	2	0	2
val_AA10.5_filter3	OTC	2	1	0	3
val_AA10.5_filter3	PA/MMA	7	2	0	9
val_AA10.5_filter3	PKU	30	2	0	32
val_AA10.5_filter3	SCAD	5	10	0	15
val_AA10.5_filter3	TFP	0	1	0	1
val_AA10.5_filter3	VLCAD	2	2	0	4
AA10.8_filter2	3MCC	9	32	0	41
AA10.8_filter2	ARG	1	2	0	3
AA10.8_filter2	BKT	0	3	0	3
AA10.8_filter2	CIT	14	14	0	28
AA10.8_filter2	CPT I	1	0	0	1
AA10.8_filter2	CPT II	3	5	0	8
AA10.8_filter2	CTD	20	21	1	42
AA10.8_filter2	GA-I	16	15	0	31
AA10.8_filter2	GA2	5	6	0	11
AA10.8_filter2	HCY	2	7	1	10
AA10.8_filter2	HYPRO	0	2	0	2
AA10.8_filter2	IVA	13	20	1	34
AA10.8_filter2	LCHAD	5	4	0	9
AA10.8_filter2	MAL	1	5	0	6
AA10.8_filter2	MCAD	79	76	0	155
AA10.8_filter2	MCD	1	3	0	4
AA10.8_filter2	MSUD	9	16	0	25
AA10.8_filter2	OTC	8	6	0	14
AA10.8_filter2	PA/MMA	50	29	0	79
AA10.8_filter2	PKU	104	11	0	115
AA10.8_filter2	RMD	1	0	0	1
AA10.8_filter2	SCAD	7	70	0	77
AA10.8_filter2	TFP	1	3	0	4
AA10.8_filter2	TYRO1	5	1	0	6
AA10.8_filter2	VLCAD	21	20	0	41
val_AA10.2_filter2	3MCC	14	1	0	15
val_AA10.2_filter2	BKT	1	0	0	1
val_AA10.2_filter2	CIT	4	2	0	6
val_AA10.2_filter2	CTD	9	0	0	9
val_AA10.2_filter2	GA-I	1	0	0	1
val_AA10.2_filter2	GA2	3	1	0	4
val_AA10.2_filter2	HCY	1	0	0	1
val_AA10.2_filter2	IVA	3	0	0	3
val_AA10.2_filter2	MCAD	16	1	0	17
val_AA10.2_filter2	MCD	1	0	0	1
val_AA10.2_filter2	MSUD	2	1	0	3
val_AA10.2_filter2	OTC	4	1	0	5
val_AA10.2_filter2	PA/MMA	9	0	0	9
val_AA10.2_filter2	PKU	39	0	0	39
val_AA10.2_filter2	SCAD	9	8	0	17
val_AA10.2_filter2	TFP	1	0	0	1
val_AA10.2_filter2	VLCAD	5	0	0	5
test_AA10.6.NonSyn.02_filter3	3MCC	8	12	2	22
test_AA10.6.NonSyn.02_filter3	ARG	1	1	1	3
test_AA10.6.NonSyn.02_filter3	BKT	0	2	0	2
test_AA10.6.NonSyn.02_filter3	CIT	15	7	0	22
test_AA10.6.NonSyn.02_filter3	CPT I	0	1	0	1
test_AA10.6.NonSyn.02_filter3	CPT II	1	4	1	6
test_AA10.6.NonSyn.02_filter3	CTD	12	14	3	29
test_AA10.6.NonSyn.02_filter3	GA-I	16	10	1	27
test_AA10.6.NonSyn.02_filter3	GA2	4	3	0	7
test_AA10.6.NonSyn.02_filter3	HCY	4	3	1	8
test_AA10.6.NonSyn.02_filter3	HYPRO	0	2	0	2
test_AA10.6.NonSyn.02_filter3	IVA	13	12	2	27
test_AA10.6.NonSyn.02_filter3	LCHAD	2	4	1	7
test_AA10.6.NonSyn.02_filter3	MAL	1	5	0	6
test_AA10.6.NonSyn.02_filter3	MCAD	95	29	4	128
test_AA10.6.NonSyn.02_filter3	MCD	1	2	0	3
test_AA10.6.NonSyn.02_filter3	MSUD	11	7	0	18
test_AA10.6.NonSyn.02_filter3	OTC	5	1	0	6
test_AA10.6.NonSyn.02_filter3	PA/MMA	16	45	3	64
test_AA10.6.NonSyn.02_filter3	PKU	27	28	1	56
test_AA10.6.NonSyn.02_filter3	SCAD	21	27	4	52
test_AA10.6.NonSyn.02_filter3	TFP	1	2	0	3
test_AA10.6.NonSyn.02_filter3	TYRO1	3	3	0	6
test_AA10.6.NonSyn.02_filter3	VLCAD	18	17	0	35
test_AA10.6.NonSyn.005	3MCC	13	16	1	30
test_AA10.6.NonSyn.005	ARG	1	2	1	4
test_AA10.6.NonSyn.005	BKT	0	2	0	2
test_AA10.6.NonSyn.005	CIT	16	9	1	26
test_AA10.6.NonSyn.005	CPT I	0	1	0	1
test_AA10.6.NonSyn.005	CPT II	1	7	0	8
test_AA10.6.NonSyn.005	CTD	18	18	2	38
test_AA10.6.NonSyn.005	GA-I	23	12	0	35
test_AA10.6.NonSyn.005	GA2	4	4	0	8
test_AA10.6.NonSyn.005	HCY	5	4	2	11
test_AA10.6.NonSyn.005	HYPRO	0	3	0	3
test_AA10.6.NonSyn.005	IVA	22	13	2	37
test_AA10.6.NonSyn.005	LCHAD	2	7	0	9
test_AA10.6.NonSyn.005	MAL	1	5	0	6
test_AA10.6.NonSyn.005	MCAD	118	38	1	157
test_AA10.6.NonSyn.005	MCD	1	3	0	4
test_AA10.6.NonSyn.005	MSUD	12	9	1	22
test_AA10.6.NonSyn.005	OTC	7	4	0	11
test_AA10.6.NonSyn.005	PA/MMA	19	60	2	81
test_AA10.6.NonSyn.005	PKU	43	48	1	92
test_AA10.6.NonSyn.005	RMD	1	2	0	3
test_AA10.6.NonSyn.005	SCAD	23	43	1	67
test_AA10.6.NonSyn.005	TFP	1	2	0	3
test_AA10.6.NonSyn.005	TYRO1	3	4	0	7
test_AA10.6.NonSyn.005	VLCAD	23	19	0	42
test_AA10.6.NonSyn.01_filter2	3MCC	10	15	1	26
test_AA10.6.NonSyn.01_filter2	ARG	1	1	1	3
test_AA10.6.NonSyn.01_filter2	BKT	0	2	0	2
test_AA10.6.NonSyn.01_filter2	CIT	15	7	0	22
test_AA10.6.NonSyn.01_filter2	CPT I	0	1	0	1
test_AA10.6.NonSyn.01_filter2	CPT II	1	7	0	8
test_AA10.6.NonSyn.01_filter2	CTD	15	15	3	33
test_AA10.6.NonSyn.01_filter2	GA-I	19	11	0	30
test_AA10.6.NonSyn.01_filter2	GA2	4	3	0	7
test_AA10.6.NonSyn.01_filter2	HCY	4	3	2	9
test_AA10.6.NonSyn.01_filter2	HYPRO	0	2	0	2
test_AA10.6.NonSyn.01_filter2	IVA	16	13	2	31
test_AA10.6.NonSyn.01_filter2	LCHAD	2	6	1	9
test_AA10.6.NonSyn.01_filter2	MAL	1	5	0	6
test_AA10.6.NonSyn.01_filter2	MCAD	103	34	1	138
test_AA10.6.NonSyn.01_filter2	MCD	1	2	0	3
test_AA10.6.NonSyn.01_filter2	MSUD	12	9	1	22
test_AA10.6.NonSyn.01_filter2	OTC	6	3	0	9
test_AA10.6.NonSyn.01_filter2	PA/MMA	18	49	3	70
test_AA10.6.NonSyn.01_filter2	PKU	36	39	1	76
test_AA10.6.NonSyn.01_filter2	RMD	1	0	0	1
test_AA10.6.NonSyn.01_filter2	SCAD	22	35	3	60
test_AA10.6.NonSyn.01_filter2	TFP	1	2	0	3
test_AA10.6.NonSyn.01_filter2	TYRO1	3	3	0	6
test_AA10.6.NonSyn.01_filter2	VLCAD	19	17	0	36
val_AA10.4_filter3	3MCC	11	0	0	11
val_AA10.4_filter3	CIT	3	2	0	5
val_AA10.4_filter3	CTD	9	0	0	9
val_AA10.4_filter3	GA-I	1	0	0	1
val_AA10.4_filter3	GA2	2	0	0	2
val_AA10.4_filter3	HCY	0	1	0	1
val_AA10.4_filter3	IVA	2	0	0	2
val_AA10.4_filter3	MCAD	11	1	0	12
val_AA10.4_filter3	MCD	1	0	0	1
val_AA10.4_filter3	MSUD	1	1	0	2
val_AA10.4_filter3	OTC	3	0	0	3
val_AA10.4_filter3	PA/MMA	8	1	0	9
val_AA10.4_filter3	PKU	31	1	0	32
val_AA10.4_filter3	SCAD	8	7	0	15
val_AA10.4_filter3	TFP	1	0	0	1
val_AA10.4_filter3	VLCAD	4	0	0	4
AA10.2_batch1	3MCC	14	1	0	15
AA10.2_batch1	BKT	1	0	0	1
AA10.2_batch1	CIT	5	2	0	7
AA10.2_batch1	CTD	9	0	0	9
AA10.2_batch1	GA-I	1	0	0	1
AA10.2_batch1	GA2	3	1	0	4
AA10.2_batch1	HCY	1	0	0	1
AA10.2_batch1	IVA	3	0	0	3
AA10.2_batch1	MCAD	16	1	0	17
AA10.2_batch1	MCD	1	0	0	1
AA10.2_batch1	MSUD	2	1	0	3
AA10.2_batch1	OTC	4	1	0	5
AA10.2_batch1	PA/MMA	9	0	0	9
AA10.2_batch1	PKU	39	0	0	39
AA10.2_batch1	SCAD	9	8	0	17
AA10.2_batch1	TFP	1	0	0	1
AA10.2_batch1	VLCAD	5	0	0	5
test_AA10.1	3MCC	19	10	1	30
test_AA10.1	ARG	4	0	0	4
test_AA10.1	BKT	2	0	0	2
test_AA10.1	CIT	23	3	0	26
test_AA10.1	CPT I	1	0	0	1
test_AA10.1	CPT II	5	3	0	8
test_AA10.1	CTD	27	9	2	38
test_AA10.1	GA-I	30	4	1	35
test_AA10.1	GA2	6	2	0	8
test_AA10.1	HCY	8	2	1	11
test_AA10.1	HYPRO	0	3	0	3
test_AA10.1	IVA	31	5	1	37
test_AA10.1	LCHAD	9	0	0	9
test_AA10.1	MAL	2	4	0	6
test_AA10.1	MCAD	146	10	1	157
test_AA10.1	MCD	1	3	0	4
test_AA10.1	MSUD	19	3	0	22
test_AA10.1	OTC	9	2	0	11
test_AA10.1	PA/MMA	65	15	1	81
test_AA10.1	PKU	84	8	0	92
test_AA10.1	RMD	3	0	0	3
test_AA10.1	SCAD	31	33	3	67
test_AA10.1	TFP	3	0	0	3
test_AA10.1	TYRO1	7	0	0	7
test_AA10.1	VLCAD	36	6	0	42
test_AA10.9.NoOneGene_filter2	3MCC	16	9	1	26
test_AA10.9.NoOneGene_filter2	ARG	3	0	0	3
test_AA10.9.NoOneGene_filter2	BKT	2	0	0	2
test_AA10.9.NoOneGene_filter2	CIT	20	2	0	22
test_AA10.9.NoOneGene_filter2	CPT I	1	0	0	1
test_AA10.9.NoOneGene_filter2	CPT II	5	3	0	8
test_AA10.9.NoOneGene_filter2	CTD	25	7	1	33
test_AA10.9.NoOneGene_filter2	GA-I	26	4	0	30
test_AA10.9.NoOneGene_filter2	GA2	6	1	0	7
test_AA10.9.NoOneGene_filter2	HCY	7	1	1	9
test_AA10.9.NoOneGene_filter2	HYPRO	0	2	0	2
test_AA10.9.NoOneGene_filter2	IVA	25	5	1	31
test_AA10.9.NoOneGene_filter2	LCHAD	9	0	0	9
test_AA10.9.NoOneGene_filter2	MAL	2	4	0	6
test_AA10.9.NoOneGene_filter2	MCAD	127	10	1	138
test_AA10.9.NoOneGene_filter2	MCD	1	2	0	3
test_AA10.9.NoOneGene_filter2	MSUD	20	2	0	22
test_AA10.9.NoOneGene_filter2	OTC	8	1	0	9
test_AA10.9.NoOneGene_filter2	PA/MMA	56	13	1	70
test_AA10.9.NoOneGene_filter2	PKU	71	5	0	76
test_AA10.9.NoOneGene_filter2	RMD	1	0	0	1
test_AA10.9.NoOneGene_filter2	SCAD	28	29	3	60
test_AA10.9.NoOneGene_filter2	TFP	3	0	0	3
test_AA10.9.NoOneGene_filter2	TYRO1	6	0	0	6
test_AA10.9.NoOneGene_filter2	VLCAD	30	6	0	36
AA10.7_filter3	3MCC	8	25	0	33
AA10.7_filter3	ARG	1	2	0	3
AA10.7_filter3	BKT	0	2	0	2
AA10.7_filter3	CIT	14	13	0	27
AA10.7_filter3	CPT I	1	0	0	1
AA10.7_filter3	CPT II	2	4	0	6
AA10.7_filter3	CTD	19	17	2	38
AA10.7_filter3	GA-I	13	15	0	28
AA10.7_filter3	GA2	4	5	0	9
AA10.7_filter3	HCY	4	4	1	9
AA10.7_filter3	HYPRO	0	2	0	2
AA10.7_filter3	IVA	12	15	2	29
AA10.7_filter3	LCHAD	4	3	0	7
AA10.7_filter3	MAL	1	5	0	6
AA10.7_filter3	MCAD	72	67	1	140
AA10.7_filter3	MCD	1	3	0	4
AA10.7_filter3	MSUD	5	15	0	20
AA10.7_filter3	OTC	7	2	0	9
AA10.7_filter3	PA/MMA	47	26	0	73
AA10.7_filter3	PKU	80	8	0	88
AA10.7_filter3	SCAD	16	49	2	67
AA10.7_filter3	TFP	1	3	0	4
AA10.7_filter3	TYRO1	5	1	0	6
AA10.7_filter3	VLCAD	19	20	0	39
test_AA10.6_filter3	3MCC	14	7	1	22
test_AA10.6_filter3	ARG	3	0	0	3
test_AA10.6_filter3	BKT	2	0	0	2
test_AA10.6_filter3	CIT	20	2	0	22
test_AA10.6_filter3	CPT I	1	0	0	1
test_AA10.6_filter3	CPT II	3	3	0	6
test_AA10.6_filter3	CTD	19	8	2	29
test_AA10.6_filter3	GA-I	23	4	0	27
test_AA10.6_filter3	GA2	6	1	0	7
test_AA10.6_filter3	HCY	5	2	1	8
test_AA10.6_filter3	HYPRO	0	2	0	2
test_AA10.6_filter3	IVA	21	5	1	27
test_AA10.6_filter3	LCHAD	7	0	0	7
test_AA10.6_filter3	MAL	2	4	0	6
test_AA10.6_filter3	MCAD	112	15	1	128
test_AA10.6_filter3	MCD	1	2	0	3
test_AA10.6_filter3	MSUD	16	2	0	18
test_AA10.6_filter3	OTC	6	0	0	6
test_AA10.6_filter3	PA/MMA	50	13	1	64
test_AA10.6_filter3	PKU	51	5	0	56
test_AA10.6_filter3	SCAD	25	26	1	52
test_AA10.6_filter3	TFP	3	0	0	3
test_AA10.6_filter3	TYRO1	6	0	0	6
test_AA10.6_filter3	VLCAD	27	8	0	35
val_AA10.3_filter3	3MCC	11	0	0	11
val_AA10.3_filter3	CIT	3	2	0	5
val_AA10.3_filter3	CTD	9	0	0	9
val_AA10.3_filter3	GA-I	1	0	0	1
val_AA10.3_filter3	GA2	2	0	0	2
val_AA10.3_filter3	HCY	1	0	0	1
val_AA10.3_filter3	IVA	0	2	0	2
val_AA10.3_filter3	MCAD	11	1	0	12
val_AA10.3_filter3	MCD	1	0	0	1
val_AA10.3_filter3	MSUD	1	1	0	2
val_AA10.3_filter3	OTC	2	1	0	3
val_AA10.3_filter3	PA/MMA	8	1	0	9
val_AA10.3_filter3	PKU	32	0	0	32
val_AA10.3_filter3	SCAD	8	7	0	15
val_AA10.3_filter3	TFP	1	0	0	1
val_AA10.3_filter3	VLCAD	4	0	0	4
test_AA10.5_filter3	3MCC	5	17	0	22
test_AA10.5_filter3	ARG	1	2	0	3
test_AA10.5_filter3	BKT	0	2	0	2
test_AA10.5_filter3	CIT	11	11	0	22
test_AA10.5_filter3	CPT I	1	0	0	1
test_AA10.5_filter3	CPT II	2	4	0	6
test_AA10.5_filter3	CTD	12	15	2	29
test_AA10.5_filter3	GA-I	13	14	0	27
test_AA10.5_filter3	GA2	3	4	0	7
test_AA10.5_filter3	HCY	3	4	1	8
test_AA10.5_filter3	HYPRO	0	2	0	2
test_AA10.5_filter3	IVA	13	12	2	27
test_AA10.5_filter3	LCHAD	4	3	0	7
test_AA10.5_filter3	MAL	1	5	0	6
test_AA10.5_filter3	MCAD	69	57	2	128
test_AA10.5_filter3	MCD	1	2	0	3
test_AA10.5_filter3	MSUD	7	11	0	18
test_AA10.5_filter3	OTC	6	0	0	6
test_AA10.5_filter3	PA/MMA	42	22	0	64
test_AA10.5_filter3	PKU	50	6	0	56
test_AA10.5_filter3	SCAD	11	39	2	52
test_AA10.5_filter3	TFP	1	2	0	3
test_AA10.5_filter3	TYRO1	5	1	0	6
test_AA10.5_filter3	VLCAD	17	18	0	35
val_AA10.6_filter3	3MCC	11	0	0	11
val_AA10.6_filter3	CIT	3	2	0	5
val_AA10.6_filter3	CTD	9	0	0	9
val_AA10.6_filter3	GA-I	1	0	0	1
val_AA10.6_filter3	GA2	2	0	0	2
val_AA10.6_filter3	HCY	0	1	0	1
val_AA10.6_filter3	IVA	0	2	0	2
val_AA10.6_filter3	MCAD	11	1	0	12
val_AA10.6_filter3	MCD	1	0	0	1
val_AA10.6_filter3	MSUD	1	1	0	2
val_AA10.6_filter3	OTC	2	1	0	3
val_AA10.6_filter3	PA/MMA	7	2	0	9
val_AA10.6_filter3	PKU	31	1	0	32
val_AA10.6_filter3	SCAD	8	7	0	15
val_AA10.6_filter3	TFP	1	0	0	1
val_AA10.6_filter3	VLCAD	4	0	0	4
AA10.1_batch1	3MCC	14	1	0	15
AA10.1_batch1	BKT	1	0	0	1
AA10.1_batch1	CIT	5	2	0	7
AA10.1_batch1	CTD	9	0	0	9
AA10.1_batch1	GA-I	1	0	0	1
AA10.1_batch1	GA2	3	1	0	4
AA10.1_batch1	HCY	1	0	0	1
AA10.1_batch1	IVA	3	0	0	3
AA10.1_batch1	MCAD	16	1	0	17
AA10.1_batch1	MCD	1	0	0	1
AA10.1_batch1	MSUD	2	1	0	3
AA10.1_batch1	OTC	4	1	0	5
AA10.1_batch1	PA/MMA	9	0	0	9
AA10.1_batch1	PKU	39	0	0	39
AA10.1_batch1	SCAD	9	8	0	17
AA10.1_batch1	TFP	1	0	0	1
AA10.1_batch1	VLCAD	5	0	0	5
AA10.7_batch2	3MCC	2	11	0	13
AA10.7_batch2	ARG	1	1	0	2
AA10.7_batch2	CIT	5	4	0	9
AA10.7_batch2	CPT I	1	0	0	1
AA10.7_batch2	CPT II	0	1	0	1
AA10.7_batch2	CTD	5	3	0	8
AA10.7_batch2	GA-I	6	2	0	8
AA10.7_batch2	GA2	0	2	0	2
AA10.7_batch2	HCY	0	1	0	1
AA10.7_batch2	IVA	7	5	1	13
AA10.7_batch2	LCHAD	1	1	0	2
AA10.7_batch2	MAL	0	1	0	1
AA10.7_batch2	MCAD	23	17	0	40
AA10.7_batch2	MSUD	2	1	0	3
AA10.7_batch2	OTC	3	4	0	7
AA10.7_batch2	PA/MMA	11	3	0	14
AA10.7_batch2	PKU	58	3	0	61
AA10.7_batch2	RMD	3	0	0	3
AA10.7_batch2	SCAD	4	26	1	31
AA10.7_batch2	TFP	0	1	0	1
AA10.7_batch2	TYRO1	1	0	0	1
AA10.7_batch2	VLCAD	1	4	0	5
AA10.1_batch2	3MCC	6	6	1	13
AA10.1_batch2	ARG	2	0	0	2
AA10.1_batch2	CIT	7	2	0	9
AA10.1_batch2	CPT I	1	0	0	1
AA10.1_batch2	CPT II	0	1	0	1
AA10.1_batch2	CTD	7	1	0	8
AA10.1_batch2	GA-I	8	0	0	8
AA10.1_batch2	GA2	1	1	0	2
AA10.1_batch2	HCY	1	0	0	1
AA10.1_batch2	IVA	13	0	0	13
AA10.1_batch2	LCHAD	2	0	0	2
AA10.1_batch2	MAL	0	1	0	1
AA10.1_batch2	MCAD	40	0	0	40
AA10.1_batch2	MSUD	3	0	0	3
AA10.1_batch2	OTC	5	2	0	7
AA10.1_batch2	PA/MMA	13	1	0	14
AA10.1_batch2	PKU	59	2	0	61
AA10.1_batch2	RMD	3	0	0	3
AA10.1_batch2	SCAD	9	21	1	31
AA10.1_batch2	TFP	1	0	0	1
AA10.1_batch2	TYRO1	1	0	0	1
AA10.1_batch2	VLCAD	5	0	0	5
test_AA10.1_batch3	3MCC	13	4	0	17
test_AA10.1_batch3	ARG	2	0	0	2
test_AA10.1_batch3	BKT	2	0	0	2
test_AA10.1_batch3	CIT	16	1	0	17
test_AA10.1_batch3	CPT II	5	2	0	7
test_AA10.1_batch3	CTD	20	8	2	30
test_AA10.1_batch3	GA-I	22	4	1	27
test_AA10.1_batch3	GA2	5	1	0	6
test_AA10.1_batch3	HCY	7	2	1	10
test_AA10.1_batch3	HYPRO	0	3	0	3
test_AA10.1_batch3	IVA	18	5	1	24
test_AA10.1_batch3	LCHAD	7	0	0	7
test_AA10.1_batch3	MAL	2	3	0	5
test_AA10.1_batch3	MCAD	106	10	1	117
test_AA10.1_batch3	MCD	1	3	0	4
test_AA10.1_batch3	MSUD	16	3	0	19
test_AA10.1_batch3	OTC	4	0	0	4
test_AA10.1_batch3	PA/MMA	52	14	1	67
test_AA10.1_batch3	PKU	25	6	0	31
test_AA10.1_batch3	SCAD	22	12	2	36
test_AA10.1_batch3	TFP	2	0	0	2
test_AA10.1_batch3	TYRO1	6	0	0	6
test_AA10.1_batch3	VLCAD	31	6	0	37
test_AA10.3_filter3	3MCC	14	7	1	22
test_AA10.3_filter3	ARG	3	0	0	3
test_AA10.3_filter3	BKT	2	0	0	2
test_AA10.3_filter3	CIT	20	2	0	22
test_AA10.3_filter3	CPT I	1	0	0	1
test_AA10.3_filter3	CPT II	3	3	0	6
test_AA10.3_filter3	CTD	20	7	2	29
test_AA10.3_filter3	GA-I	23	4	0	27
test_AA10.3_filter3	GA2	6	1	0	7
test_AA10.3_filter3	HCY	6	1	1	8
test_AA10.3_filter3	HYPRO	0	2	0	2
test_AA10.3_filter3	IVA	21	5	1	27
test_AA10.3_filter3	LCHAD	7	0	0	7
test_AA10.3_filter3	MAL	2	4	0	6
test_AA10.3_filter3	MCAD	116	12	0	128
test_AA10.3_filter3	MCD	1	2	0	3
test_AA10.3_filter3	MSUD	16	2	0	18
test_AA10.3_filter3	OTC	6	0	0	6
test_AA10.3_filter3	PA/MMA	50	13	1	64
test_AA10.3_filter3	PKU	51	5	0	56
test_AA10.3_filter3	SCAD	25	25	2	52
test_AA10.3_filter3	TFP	3	0	0	3
test_AA10.3_filter3	TYRO1	6	0	0	6
test_AA10.3_filter3	VLCAD	29	6	0	35
test_AA10.5	3MCC	8	22	0	30
test_AA10.5	ARG	2	2	0	4
test_AA10.5	BKT	0	2	0	2
test_AA10.5	CIT	14	12	0	26
test_AA10.5	CPT I	1	0	0	1
test_AA10.5	CPT II	3	5	0	8
test_AA10.5	CTD	17	19	2	38
test_AA10.5	GA-I	20	14	1	35
test_AA10.5	GA2	3	5	0	8
test_AA10.5	HCY	4	6	1	11
test_AA10.5	HYPRO	0	3	0	3
test_AA10.5	IVA	18	17	2	37
test_AA10.5	LCHAD	5	4	0	9
test_AA10.5	MAL	1	5	0	6
test_AA10.5	MCAD	87	67	3	157
test_AA10.5	MCD	1	3	0	4
test_AA10.5	MSUD	10	12	0	22
test_AA10.5	OTC	7	4	0	11
test_AA10.5	PA/MMA	54	27	0	81
test_AA10.5	PKU	83	9	0	92
test_AA10.5	RMD	3	0	0	3
test_AA10.5	SCAD	15	50	2	67
test_AA10.5	TFP	1	2	0	3
test_AA10.5	TYRO1	6	1	0	7
test_AA10.5	VLCAD	20	22	0	42
AA10.7	3MCC	11	34	0	45
AA10.7	ARG	2	2	0	4
AA10.7	BKT	0	3	0	3
AA10.7	CIT	18	15	0	33
AA10.7	CPT I	1	0	0	1
AA10.7	CPT II	3	5	0	8
AA10.7	CTD	24	21	2	47
AA10.7	GA-I	20	15	1	36
AA10.7	GA2	5	7	0	12
AA10.7	HCY	5	6	1	12
AA10.7	HYPRO	0	3	0	3
AA10.7	IVA	18	20	2	40
AA10.7	LCHAD	5	4	0	9
AA10.7	MAL	1	5	0	6
AA10.7	MCAD	91	81	2	174
AA10.7	MCD	1	4	0	5
AA10.7	MSUD	9	16	0	25
AA10.7	OTC	8	8	0	16
AA10.7	PA/MMA	59	31	0	90
AA10.7	PKU	120	11	0	131
AA10.7	RMD	3	0	0	3
AA10.7	SCAD	21	61	2	84
AA10.7	TFP	1	3	0	4
AA10.7	TYRO1	6	1	0	7
AA10.7	VLCAD	23	24	0	47
AA10.5_filter3	3MCC	8	25	0	33
AA10.5_filter3	ARG	1	2	0	3
AA10.5_filter3	BKT	0	2	0	2
AA10.5_filter3	CIT	14	13	0	27
AA10.5_filter3	CPT I	1	0	0	1
AA10.5_filter3	CPT II	2	4	0	6
AA10.5_filter3	CTD	19	17	2	38
AA10.5_filter3	GA-I	13	15	0	28
AA10.5_filter3	GA2	4	5	0	9
AA10.5_filter3	HCY	4	4	1	9
AA10.5_filter3	HYPRO	0	2	0	2
AA10.5_filter3	IVA	15	12	2	29
AA10.5_filter3	LCHAD	4	3	0	7
AA10.5_filter3	MAL	1	5	0	6
AA10.5_filter3	MCAD	73	65	2	140
AA10.5_filter3	MCD	1	3	0	4
AA10.5_filter3	MSUD	7	13	0	20
AA10.5_filter3	OTC	8	1	0	9
AA10.5_filter3	PA/MMA	49	24	0	73
AA10.5_filter3	PKU	80	8	0	88
AA10.5_filter3	SCAD	16	49	2	67
AA10.5_filter3	TFP	1	3	0	4
AA10.5_filter3	TYRO1	5	1	0	6
AA10.5_filter3	VLCAD	19	20	0	39
test_AA10.7_filter4	3MCC	3	10	0	13
test_AA10.7_filter4	ARG	0	1	0	1
test_AA10.7_filter4	BKT	0	2	0	2
test_AA10.7_filter4	CIT	8	6	0	14
test_AA10.7_filter4	CPT II	2	4	0	6
test_AA10.7_filter4	CTD	10	12	2	24
test_AA10.7_filter4	GA-I	12	11	0	23
test_AA10.7_filter4	GA2	3	2	0	5
test_AA10.7_filter4	HCY	3	3	1	7
test_AA10.7_filter4	HYPRO	0	1	0	1
test_AA10.7_filter4	IVA	7	12	1	20
test_AA10.7_filter4	LCHAD	3	3	0	6
test_AA10.7_filter4	MAL	1	2	0	3
test_AA10.7_filter4	MCAD	53	43	1	97
test_AA10.7_filter4	MCD	1	2	0	3
test_AA10.7_filter4	MSUD	4	6	0	10
test_AA10.7_filter4	OTC	5	0	0	5
test_AA10.7_filter4	PA/MMA	32	20	0	52
test_AA10.7_filter4	PKU	21	4	0	25
test_AA10.7_filter4	SCAD	11	19	1	31
test_AA10.7_filter4	TFP	1	2	0	3
test_AA10.7_filter4	TYRO1	5	1	0	6
test_AA10.7_filter4	VLCAD	14	13	0	27
AA10.6.NonSyn.02_filter4	3MCC	10	14	0	24
AA10.6.NonSyn.02_filter4	ARG	1	0	0	1
AA10.6.NonSyn.02_filter4	BKT	0	2	0	2
AA10.6.NonSyn.02_filter4	CIT	11	7	1	19
AA10.6.NonSyn.02_filter4	CPT II	1	4	1	6
AA10.6.NonSyn.02_filter4	CTD	13	16	4	33
AA10.6.NonSyn.02_filter4	GA-I	15	9	0	24
AA10.6.NonSyn.02_filter4	GA2	5	2	0	7
AA10.6.NonSyn.02_filter4	HCY	3	4	1	8
AA10.6.NonSyn.02_filter4	HYPRO	0	1	0	1
AA10.6.NonSyn.02_filter4	IVA	8	12	2	22
AA10.6.NonSyn.02_filter4	LCHAD	2	3	1	6
AA10.6.NonSyn.02_filter4	MAL	1	2	0	3
AA10.6.NonSyn.02_filter4	MCAD	81	25	3	109
AA10.6.NonSyn.02_filter4	MCD	1	3	0	4
AA10.6.NonSyn.02_filter4	MSUD	7	5	0	12
AA10.6.NonSyn.02_filter4	OTC	6	2	0	8
AA10.6.NonSyn.02_filter4	PA/MMA	16	42	3	61
AA10.6.NonSyn.02_filter4	PKU	31	26	0	57
AA10.6.NonSyn.02_filter4	SCAD	25	19	2	46
AA10.6.NonSyn.02_filter4	TFP	1	3	0	4
AA10.6.NonSyn.02_filter4	TYRO1	3	3	0	6
AA10.6.NonSyn.02_filter4	VLCAD	16	15	0	31
AA10.6.NonSyn.02	3MCC	21	22	2	45
AA10.6.NonSyn.02	ARG	1	2	1	4
AA10.6.NonSyn.02	BKT	1	2	0	3
AA10.6.NonSyn.02	CIT	19	12	2	33
AA10.6.NonSyn.02	CPT I	0	1	0	1
AA10.6.NonSyn.02	CPT II	1	6	1	8
AA10.6.NonSyn.02	CTD	22	20	5	47
AA10.6.NonSyn.02	GA-I	24	11	1	36
AA10.6.NonSyn.02	GA2	7	5	0	12
AA10.6.NonSyn.02	HCY	5	5	2	12
AA10.6.NonSyn.02	HYPRO	0	3	0	3
AA10.6.NonSyn.02	IVA	23	14	3	40
AA10.6.NonSyn.02	LCHAD	2	6	1	9
AA10.6.NonSyn.02	MAL	1	5	0	6
AA10.6.NonSyn.02	MCAD	132	38	4	174
AA10.6.NonSyn.02	MCD	1	4	0	5
AA10.6.NonSyn.02	MSUD	13	10	2	25
AA10.6.NonSyn.02	OTC	10	6	0	16
AA10.6.NonSyn.02	PA/MMA	24	61	5	90
AA10.6.NonSyn.02	PKU	65	63	3	131
AA10.6.NonSyn.02	RMD	1	2	0	3
AA10.6.NonSyn.02	SCAD	32	47	5	84
AA10.6.NonSyn.02	TFP	1	3	0	4
AA10.6.NonSyn.02	TYRO1	3	4	0	7
AA10.6.NonSyn.02	VLCAD	25	22	0	47
test_AA10.6.NonSyn.02_filter1	3MCC	11	14	2	27
test_AA10.6.NonSyn.02_filter1	ARG	1	1	1	3
test_AA10.6.NonSyn.02_filter1	BKT	0	2	0	2
test_AA10.6.NonSyn.02_filter1	CIT	16	7	0	23
test_AA10.6.NonSyn.02_filter1	CPT I	0	1	0	1
test_AA10.6.NonSyn.02_filter1	CPT II	1	6	1	8
test_AA10.6.NonSyn.02_filter1	CTD	16	14	4	34
test_AA10.6.NonSyn.02_filter1	GA-I	20	10	1	31
test_AA10.6.NonSyn.02_filter1	GA2	4	3	0	7
test_AA10.6.NonSyn.02_filter1	HCY	5	3	2	10
test_AA10.6.NonSyn.02_filter1	HYPRO	0	2	0	2
test_AA10.6.NonSyn.02_filter1	IVA	18	13	2	33
test_AA10.6.NonSyn.02_filter1	LCHAD	2	6	1	9
test_AA10.6.NonSyn.02_filter1	MAL	1	5	0	6
test_AA10.6.NonSyn.02_filter1	MCAD	106	33	4	143
test_AA10.6.NonSyn.02_filter1	MCD	1	2	0	3
test_AA10.6.NonSyn.02_filter1	MSUD	12	9	1	22
test_AA10.6.NonSyn.02_filter1	OTC	6	3	0	9
test_AA10.6.NonSyn.02_filter1	PA/MMA	18	51	4	73
test_AA10.6.NonSyn.02_filter1	PKU	38	40	1	79
test_AA10.6.NonSyn.02_filter1	RMD	1	0	0	1
test_AA10.6.NonSyn.02_filter1	SCAD	24	35	4	63
test_AA10.6.NonSyn.02_filter1	TFP	1	2	0	3
test_AA10.6.NonSyn.02_filter1	TYRO1	3	4	0	7
test_AA10.6.NonSyn.02_filter1	VLCAD	21	18	0	39
val_AA10.6.NonSyn.01	3MCC	8	7	0	15
val_AA10.6.NonSyn.01	BKT	1	0	0	1
val_AA10.6.NonSyn.01	CIT	3	3	1	7
val_AA10.6.NonSyn.01	CTD	4	4	1	9
val_AA10.6.NonSyn.01	GA-I	1	0	0	1
val_AA10.6.NonSyn.01	GA2	3	1	0	4
val_AA10.6.NonSyn.01	HCY	0	1	0	1
val_AA10.6.NonSyn.01	IVA	1	2	0	3
val_AA10.6.NonSyn.01	MCAD	14	3	0	17
val_AA10.6.NonSyn.01	MCD	0	1	0	1
val_AA10.6.NonSyn.01	MSUD	1	1	1	3
val_AA10.6.NonSyn.01	OTC	3	2	0	5
val_AA10.6.NonSyn.01	PA/MMA	4	5	0	9
val_AA10.6.NonSyn.01	PKU	22	17	0	39
val_AA10.6.NonSyn.01	SCAD	8	9	0	17
val_AA10.6.NonSyn.01	TFP	0	1	0	1
val_AA10.6.NonSyn.01	VLCAD	2	3	0	5
test_AA10.4_filter3	3MCC	14	7	1	22
test_AA10.4_filter3	ARG	3	0	0	3
test_AA10.4_filter3	BKT	2	0	0	2
test_AA10.4_filter3	CIT	20	2	0	22
test_AA10.4_filter3	CPT I	1	0	0	1
test_AA10.4_filter3	CPT II	3	3	0	6
test_AA10.4_filter3	CTD	19	8	2	29
test_AA10.4_filter3	GA-I	23	4	0	27
test_AA10.4_filter3	GA2	6	1	0	7
test_AA10.4_filter3	HCY	5	2	1	8
test_AA10.4_filter3	HYPRO	0	2	0	2
test_AA10.4_filter3	IVA	22	4	1	27
test_AA10.4_filter3	LCHAD	7	0	0	7
test_AA10.4_filter3	MAL	2	4	0	6
test_AA10.4_filter3	MCAD	113	13	2	128
test_AA10.4_filter3	MCD	1	2	0	3
test_AA10.4_filter3	MSUD	17	1	0	18
test_AA10.4_filter3	OTC	6	0	0	6
test_AA10.4_filter3	PA/MMA	51	12	1	64
test_AA10.4_filter3	PKU	51	5	0	56
test_AA10.4_filter3	SCAD	25	26	1	52
test_AA10.4_filter3	TFP	3	0	0	3
test_AA10.4_filter3	TYRO1	6	0	0	6
test_AA10.4_filter3	VLCAD	27	8	0	35
AA10.5_filter1	3MCC	10	32	0	42
AA10.5_filter1	ARG	1	2	0	3
AA10.5_filter1	BKT	0	3	0	3
AA10.5_filter1	CIT	15	14	0	29
AA10.5_filter1	CPT I	1	0	0	1
AA10.5_filter1	CPT II	3	5	0	8
AA10.5_filter1	CTD	23	18	2	43
AA10.5_filter1	GA-I	17	15	0	32
AA10.5_filter1	GA2	5	6	0	11
AA10.5_filter1	HCY	5	5	1	11
AA10.5_filter1	HYPRO	0	2	0	2
AA10.5_filter1	IVA	18	16	2	36
AA10.5_filter1	LCHAD	5	4	0	9
AA10.5_filter1	MAL	1	5	0	6
AA10.5_filter1	MCAD	85	72	3	160
AA10.5_filter1	MCD	1	3	0	4
AA10.5_filter1	MSUD	11	14	0	25
AA10.5_filter1	OTC	9	5	0	14
AA10.5_filter1	PA/MMA	56	26	0	82
AA10.5_filter1	PKU	109	9	0	118
AA10.5_filter1	RMD	1	0	0	1
AA10.5_filter1	SCAD	21	57	2	80
AA10.5_filter1	TFP	1	3	0	4
AA10.5_filter1	TYRO1	6	1	0	7
AA10.5_filter1	VLCAD	21	23	0	44
test_AA10.6.NonSyn.005_filter3	3MCC	8	13	1	22
test_AA10.6.NonSyn.005_filter3	ARG	1	1	1	3
test_AA10.6.NonSyn.005_filter3	BKT	0	2	0	2
test_AA10.6.NonSyn.005_filter3	CIT	15	7	0	22
test_AA10.6.NonSyn.005_filter3	CPT I	0	1	0	1
test_AA10.6.NonSyn.005_filter3	CPT II	1	5	0	6
test_AA10.6.NonSyn.005_filter3	CTD	12	15	2	29
test_AA10.6.NonSyn.005_filter3	GA-I	16	11	0	27
test_AA10.6.NonSyn.005_filter3	GA2	4	3	0	7
test_AA10.6.NonSyn.005_filter3	HCY	4	3	1	8
test_AA10.6.NonSyn.005_filter3	HYPRO	0	2	0	2
test_AA10.6.NonSyn.005_filter3	IVA	13	12	2	27
test_AA10.6.NonSyn.005_filter3	LCHAD	2	5	0	7
test_AA10.6.NonSyn.005_filter3	MAL	1	5	0	6
test_AA10.6.NonSyn.005_filter3	MCAD	95	32	1	128
test_AA10.6.NonSyn.005_filter3	MCD	1	2	0	3
test_AA10.6.NonSyn.005_filter3	MSUD	11	7	0	18
test_AA10.6.NonSyn.005_filter3	OTC	5	1	0	6
test_AA10.6.NonSyn.005_filter3	PA/MMA	15	47	2	64
test_AA10.6.NonSyn.005_filter3	PKU	27	28	1	56
test_AA10.6.NonSyn.005_filter3	SCAD	20	31	1	52
test_AA10.6.NonSyn.005_filter3	TFP	1	2	0	3
test_AA10.6.NonSyn.005_filter3	TYRO1	3	3	0	6
test_AA10.6.NonSyn.005_filter3	VLCAD	18	17	0	35
val_AA10.6.NonSyn.02	3MCC	8	7	0	15
val_AA10.6.NonSyn.02	BKT	1	0	0	1
val_AA10.6.NonSyn.02	CIT	3	3	1	7
val_AA10.6.NonSyn.02	CTD	4	4	1	9
val_AA10.6.NonSyn.02	GA-I	1	0	0	1
val_AA10.6.NonSyn.02	GA2	3	1	0	4
val_AA10.6.NonSyn.02	HCY	0	1	0	1
val_AA10.6.NonSyn.02	IVA	1	1	1	3
val_AA10.6.NonSyn.02	MCAD	14	3	0	17
val_AA10.6.NonSyn.02	MCD	0	1	0	1
val_AA10.6.NonSyn.02	MSUD	1	1	1	3
val_AA10.6.NonSyn.02	OTC	3	2	0	5
val_AA10.6.NonSyn.02	PA/MMA	4	5	0	9
val_AA10.6.NonSyn.02	PKU	22	16	1	39
val_AA10.6.NonSyn.02	SCAD	8	9	0	17
val_AA10.6.NonSyn.02	TFP	0	1	0	1
val_AA10.6.NonSyn.02	VLCAD	2	3	0	5
AA10.3_filter4	3MCC	20	4	0	24
AA10.3_filter4	ARG	1	0	0	1
AA10.3_filter4	BKT	2	0	0	2
AA10.3_filter4	CIT	16	3	0	19
AA10.3_filter4	CPT II	3	3	0	6
AA10.3_filter4	CTD	25	6	2	33
AA10.3_filter4	GA-I	21	3	0	24
AA10.3_filter4	GA2	7	0	0	7
AA10.3_filter4	HCY	6	1	1	8
AA10.3_filter4	HYPRO	0	1	0	1
AA10.3_filter4	IVA	14	7	1	22
AA10.3_filter4	LCHAD	6	0	0	6
AA10.3_filter4	MAL	2	1	0	3
AA10.3_filter4	MCAD	98	11	0	109
AA10.3_filter4	MCD	2	2	0	4
AA10.3_filter4	MSUD	10	2	0	12
AA10.3_filter4	OTC	7	1	0	8
AA10.3_filter4	PA/MMA	48	12	1	61
AA10.3_filter4	PKU	53	4	0	57
AA10.3_filter4	SCAD	29	16	1	46
AA10.3_filter4	TFP	4	0	0	4
AA10.3_filter4	TYRO1	6	0	0	6
AA10.3_filter4	VLCAD	25	6	0	31
val_AA10.6_batch1	3MCC	14	1	0	15
val_AA10.6_batch1	BKT	1	0	0	1
val_AA10.6_batch1	CIT	5	2	0	7
val_AA10.6_batch1	CTD	9	0	0	9
val_AA10.6_batch1	GA-I	1	0	0	1
val_AA10.6_batch1	GA2	3	1	0	4
val_AA10.6_batch1	HCY	0	1	0	1
val_AA10.6_batch1	IVA	1	2	0	3
val_AA10.6_batch1	MCAD	16	1	0	17
val_AA10.6_batch1	MCD	1	0	0	1
val_AA10.6_batch1	MSUD	1	1	1	3
val_AA10.6_batch1	OTC	3	2	0	5
val_AA10.6_batch1	PA/MMA	7	2	0	9
val_AA10.6_batch1	PKU	37	2	0	39
val_AA10.6_batch1	SCAD	9	8	0	17
val_AA10.6_batch1	TFP	1	0	0	1
val_AA10.6_batch1	VLCAD	4	1	0	5
test_AA10.4	3MCC	19	10	1	30
test_AA10.4	ARG	4	0	0	4
test_AA10.4	BKT	2	0	0	2
test_AA10.4	CIT	23	3	0	26
test_AA10.4	CPT I	1	0	0	1
test_AA10.4	CPT II	5	3	0	8
test_AA10.4	CTD	26	10	2	38
test_AA10.4	GA-I	30	4	1	35
test_AA10.4	GA2	6	2	0	8
test_AA10.4	HCY	6	3	2	11
test_AA10.4	HYPRO	0	3	0	3
test_AA10.4	IVA	31	5	1	37
test_AA10.4	LCHAD	9	0	0	9
test_AA10.4	MAL	2	4	0	6
test_AA10.4	MCAD	141	14	2	157
test_AA10.4	MCD	1	3	0	4
test_AA10.4	MSUD	20	2	0	22
test_AA10.4	OTC	9	2	0	11
test_AA10.4	PA/MMA	65	15	1	81
test_AA10.4	PKU	84	8	0	92
test_AA10.4	RMD	3	0	0	3
test_AA10.4	SCAD	31	34	2	67
test_AA10.4	TFP	3	0	0	3
test_AA10.4	TYRO1	7	0	0	7
test_AA10.4	VLCAD	34	8	0	42
test_AA10.9.NoOneGene_filter1	3MCC	17	9	1	27
test_AA10.9.NoOneGene_filter1	ARG	3	0	0	3
test_AA10.9.NoOneGene_filter1	BKT	2	0	0	2
test_AA10.9.NoOneGene_filter1	CIT	21	2	0	23
test_AA10.9.NoOneGene_filter1	CPT I	1	0	0	1
test_AA10.9.NoOneGene_filter1	CPT II	5	3	0	8
test_AA10.9.NoOneGene_filter1	CTD	26	7	1	34
test_AA10.9.NoOneGene_filter1	GA-I	27	4	0	31
test_AA10.9.NoOneGene_filter1	GA2	6	1	0	7
test_AA10.9.NoOneGene_filter1	HCY	8	1	1	10
test_AA10.9.NoOneGene_filter1	HYPRO	0	2	0	2
test_AA10.9.NoOneGene_filter1	IVA	27	5	1	33
test_AA10.9.NoOneGene_filter1	LCHAD	9	0	0	9
test_AA10.9.NoOneGene_filter1	MAL	2	4	0	6
test_AA10.9.NoOneGene_filter1	MCAD	132	10	1	143
test_AA10.9.NoOneGene_filter1	MCD	1	2	0	3
test_AA10.9.NoOneGene_filter1	MSUD	20	2	0	22
test_AA10.9.NoOneGene_filter1	OTC	8	1	0	9
test_AA10.9.NoOneGene_filter1	PA/MMA	59	13	1	73
test_AA10.9.NoOneGene_filter1	PKU	73	6	0	79
test_AA10.9.NoOneGene_filter1	RMD	1	0	0	1
test_AA10.9.NoOneGene_filter1	SCAD	31	29	3	63
test_AA10.9.NoOneGene_filter1	TFP	3	0	0	3
test_AA10.9.NoOneGene_filter1	TYRO1	7	0	0	7
test_AA10.9.NoOneGene_filter1	VLCAD	33	6	0	39
val_AA10.6.NonSyn.005_filter3	3MCC	7	4	0	11
val_AA10.6.NonSyn.005_filter3	CIT	2	2	1	5
val_AA10.6.NonSyn.005_filter3	CTD	4	4	1	9
val_AA10.6.NonSyn.005_filter3	GA-I	1	0	0	1
val_AA10.6.NonSyn.005_filter3	GA2	2	0	0	2
val_AA10.6.NonSyn.005_filter3	HCY	0	1	0	1
val_AA10.6.NonSyn.005_filter3	IVA	0	2	0	2
val_AA10.6.NonSyn.005_filter3	MCAD	10	2	0	12
val_AA10.6.NonSyn.005_filter3	MCD	0	1	0	1
val_AA10.6.NonSyn.005_filter3	MSUD	1	1	0	2
val_AA10.6.NonSyn.005_filter3	OTC	2	1	0	3
val_AA10.6.NonSyn.005_filter3	PA/MMA	3	6	0	9
val_AA10.6.NonSyn.005_filter3	PKU	17	15	0	32
val_AA10.6.NonSyn.005_filter3	SCAD	7	8	0	15
val_AA10.6.NonSyn.005_filter3	TFP	0	1	0	1
val_AA10.6.NonSyn.005_filter3	VLCAD	2	2	0	4
test_AA10.2_batch3	3MCC	13	4	0	17
test_AA10.2_batch3	ARG	2	0	0	2
test_AA10.2_batch3	BKT	2	0	0	2
test_AA10.2_batch3	CIT	16	1	0	17
test_AA10.2_batch3	CPT II	5	2	0	7
test_AA10.2_batch3	CTD	20	8	2	30
test_AA10.2_batch3	GA-I	22	4	1	27
test_AA10.2_batch3	GA2	5	1	0	6
test_AA10.2_batch3	HCY	7	2	1	10
test_AA10.2_batch3	HYPRO	0	3	0	3
test_AA10.2_batch3	IVA	18	5	1	24
test_AA10.2_batch3	LCHAD	7	0	0	7
test_AA10.2_batch3	MAL	2	3	0	5
test_AA10.2_batch3	MCAD	106	10	1	117
test_AA10.2_batch3	MCD	1	3	0	4
test_AA10.2_batch3	MSUD	17	2	0	19
test_AA10.2_batch3	OTC	4	0	0	4
test_AA10.2_batch3	PA/MMA	52	14	1	67
test_AA10.2_batch3	PKU	25	6	0	31
test_AA10.2_batch3	SCAD	22	12	2	36
test_AA10.2_batch3	TFP	2	0	0	2
test_AA10.2_batch3	TYRO1	6	0	0	6
test_AA10.2_batch3	VLCAD	31	6	0	37
val_AA10.7_batch1	3MCC	3	12	0	15
val_AA10.7_batch1	BKT	0	1	0	1
val_AA10.7_batch1	CIT	4	3	0	7
val_AA10.7_batch1	CTD	7	2	0	9
val_AA10.7_batch1	GA-I	0	1	0	1
val_AA10.7_batch1	GA2	2	2	0	4
val_AA10.7_batch1	HCY	1	0	0	1
val_AA10.7_batch1	IVA	1	2	0	3
val_AA10.7_batch1	MCAD	5	12	0	17
val_AA10.7_batch1	MCD	0	1	0	1
val_AA10.7_batch1	MSUD	1	2	0	3
val_AA10.7_batch1	OTC	1	4	0	5
val_AA10.7_batch1	PA/MMA	6	3	0	9
val_AA10.7_batch1	PKU	37	2	0	39
val_AA10.7_batch1	SCAD	6	11	0	17
val_AA10.7_batch1	TFP	0	1	0	1
val_AA10.7_batch1	VLCAD	3	2	0	5
test_AA10.8_filter1	3MCC	7	20	0	27
test_AA10.8_filter1	ARG	1	2	0	3
test_AA10.8_filter1	BKT	0	2	0	2
test_AA10.8_filter1	CIT	12	11	0	23
test_AA10.8_filter1	CPT I	1	0	0	1
test_AA10.8_filter1	CPT II	3	5	0	8
test_AA10.8_filter1	CTD	15	18	1	34
test_AA10.8_filter1	GA-I	17	14	0	31
test_AA10.8_filter1	GA2	3	4	0	7
test_AA10.8_filter1	HCY	2	7	1	10
test_AA10.8_filter1	HYPRO	0	2	0	2
test_AA10.8_filter1	IVA	14	18	1	33
test_AA10.8_filter1	LCHAD	5	4	0	9
test_AA10.8_filter1	MAL	1	5	0	6
test_AA10.8_filter1	MCAD	78	65	0	143
test_AA10.8_filter1	MCD	1	2	0	3
test_AA10.8_filter1	MSUD	8	14	0	22
test_AA10.8_filter1	OTC	7	2	0	9
test_AA10.8_filter1	PA/MMA	47	26	0	73
test_AA10.8_filter1	PKU	70	9	0	79
test_AA10.8_filter1	RMD	1	0	0	1
test_AA10.8_filter1	SCAD	6	57	0	63
test_AA10.8_filter1	TFP	1	2	0	3
test_AA10.8_filter1	TYRO1	6	1	0	7
test_AA10.8_filter1	VLCAD	18	21	0	39
val_AA10.9.NoOneGene_filter3	3MCC	11	0	0	11
val_AA10.9.NoOneGene_filter3	CIT	3	2	0	5
val_AA10.9.NoOneGene_filter3	CTD	9	0	0	9
val_AA10.9.NoOneGene_filter3	GA-I	1	0	0	1
val_AA10.9.NoOneGene_filter3	GA2	2	0	0	2
val_AA10.9.NoOneGene_filter3	HCY	1	0	0	1
val_AA10.9.NoOneGene_filter3	IVA	2	0	0	2
val_AA10.9.NoOneGene_filter3	MCAD	11	1	0	12
val_AA10.9.NoOneGene_filter3	MCD	1	0	0	1
val_AA10.9.NoOneGene_filter3	MSUD	1	1	0	2
val_AA10.9.NoOneGene_filter3	OTC	3	0	0	3
val_AA10.9.NoOneGene_filter3	PA/MMA	9	0	0	9
val_AA10.9.NoOneGene_filter3	PKU	32	0	0	32
val_AA10.9.NoOneGene_filter3	SCAD	8	7	0	15
val_AA10.9.NoOneGene_filter3	TFP	1	0	0	1
val_AA10.9.NoOneGene_filter3	VLCAD	4	0	0	4
val_AA10.8_filter3	3MCC	3	8	0	11
val_AA10.8_filter3	CIT	3	2	0	5
val_AA10.8_filter3	CTD	5	4	0	9
val_AA10.8_filter3	GA-I	0	1	0	1
val_AA10.8_filter3	GA2	1	1	0	2
val_AA10.8_filter3	HCY	0	1	0	1
val_AA10.8_filter3	IVA	0	2	0	2
val_AA10.8_filter3	MCAD	4	8	0	12
val_AA10.8_filter3	MCD	0	1	0	1
val_AA10.8_filter3	MSUD	0	2	0	2
val_AA10.8_filter3	OTC	1	2	0	3
val_AA10.8_filter3	PA/MMA	5	4	0	9
val_AA10.8_filter3	PKU	29	3	0	32
val_AA10.8_filter3	SCAD	2	13	0	15
val_AA10.8_filter3	TFP	0	1	0	1
val_AA10.8_filter3	VLCAD	2	2	0	4
AA10.8	3MCC	11	34	0	45
AA10.8	ARG	2	2	0	4
AA10.8	BKT	0	3	0	3
AA10.8	CIT	18	15	0	33
AA10.8	CPT I	1	0	0	1
AA10.8	CPT II	3	5	0	8
AA10.8	CTD	20	26	1	47
AA10.8	GA-I	20	15	1	36
AA10.8	GA2	5	7	0	12
AA10.8	HCY	2	9	1	12
AA10.8	HYPRO	0	3	0	3
AA10.8	IVA	18	21	1	40
AA10.8	LCHAD	5	4	0	9
AA10.8	MAL	1	5	0	6
AA10.8	MCAD	89	85	0	174
AA10.8	MCD	1	4	0	5
AA10.8	MSUD	9	16	0	25
AA10.8	OTC	8	8	0	16
AA10.8	PA/MMA	57	33	0	90
AA10.8	PKU	117	14	0	131
AA10.8	RMD	3	0	0	3
AA10.8	SCAD	8	76	0	84
AA10.8	TFP	1	3	0	4
AA10.8	TYRO1	6	1	0	7
AA10.8	VLCAD	23	24	0	47
test_AA10.6.NonSyn.005_batch3	3MCC	7	10	0	17
test_AA10.6.NonSyn.005_batch3	ARG	1	1	0	2
test_AA10.6.NonSyn.005_batch3	BKT	0	2	0	2
test_AA10.6.NonSyn.005_batch3	CIT	10	7	0	17
test_AA10.6.NonSyn.005_batch3	CPT II	1	6	0	7
test_AA10.6.NonSyn.005_batch3	CTD	12	16	2	30
test_AA10.6.NonSyn.005_batch3	GA-I	18	9	0	27
test_AA10.6.NonSyn.005_batch3	GA2	4	2	0	6
test_AA10.6.NonSyn.005_batch3	HCY	4	4	2	10
test_AA10.6.NonSyn.005_batch3	HYPRO	0	3	0	3
test_AA10.6.NonSyn.005_batch3	IVA	12	11	1	24
test_AA10.6.NonSyn.005_batch3	LCHAD	2	5	0	7
test_AA10.6.NonSyn.005_batch3	MAL	1	4	0	5
test_AA10.6.NonSyn.005_batch3	MCAD	86	30	1	117
test_AA10.6.NonSyn.005_batch3	MCD	1	3	0	4
test_AA10.6.NonSyn.005_batch3	MSUD	10	8	1	19
test_AA10.6.NonSyn.005_batch3	OTC	4	0	0	4
test_AA10.6.NonSyn.005_batch3	PA/MMA	15	50	2	67
test_AA10.6.NonSyn.005_batch3	PKU	16	15	0	31
test_AA10.6.NonSyn.005_batch3	SCAD	16	19	1	36
test_AA10.6.NonSyn.005_batch3	TFP	1	1	0	2
test_AA10.6.NonSyn.005_batch3	TYRO1	2	4	0	6
test_AA10.6.NonSyn.005_batch3	VLCAD	21	16	0	37
AA10.6.NonSyn.005_batch2	3MCC	6	6	1	13
AA10.6.NonSyn.005_batch2	ARG	0	1	1	2
AA10.6.NonSyn.005_batch2	CIT	6	2	1	9
AA10.6.NonSyn.005_batch2	CPT I	0	1	0	1
AA10.6.NonSyn.005_batch2	CPT II	0	1	0	1
AA10.6.NonSyn.005_batch2	CTD	6	2	0	8
AA10.6.NonSyn.005_batch2	GA-I	5	3	0	8
AA10.6.NonSyn.005_batch2	GA2	0	2	0	2
AA10.6.NonSyn.005_batch2	HCY	1	0	0	1
AA10.6.NonSyn.005_batch2	IVA	10	2	1	13
AA10.6.NonSyn.005_batch2	LCHAD	0	2	0	2
AA10.6.NonSyn.005_batch2	MAL	0	1	0	1
AA10.6.NonSyn.005_batch2	MCAD	32	8	0	40
AA10.6.NonSyn.005_batch2	MSUD	2	1	0	3
AA10.6.NonSyn.005_batch2	OTC	3	4	0	7
AA10.6.NonSyn.005_batch2	PA/MMA	4	10	0	14
AA10.6.NonSyn.005_batch2	PKU	27	33	1	61
AA10.6.NonSyn.005_batch2	RMD	1	2	0	3
AA10.6.NonSyn.005_batch2	SCAD	7	24	0	31
AA10.6.NonSyn.005_batch2	TFP	0	1	0	1
AA10.6.NonSyn.005_batch2	TYRO1	1	0	0	1
AA10.6.NonSyn.005_batch2	VLCAD	2	3	0	5
val_AA10.2_batch1	3MCC	14	1	0	15
val_AA10.2_batch1	BKT	1	0	0	1
val_AA10.2_batch1	CIT	5	2	0	7
val_AA10.2_batch1	CTD	9	0	0	9
val_AA10.2_batch1	GA-I	1	0	0	1
val_AA10.2_batch1	GA2	3	1	0	4
val_AA10.2_batch1	HCY	1	0	0	1
val_AA10.2_batch1	IVA	3	0	0	3
val_AA10.2_batch1	MCAD	16	1	0	17
val_AA10.2_batch1	MCD	1	0	0	1
val_AA10.2_batch1	MSUD	2	1	0	3
val_AA10.2_batch1	OTC	4	1	0	5
val_AA10.2_batch1	PA/MMA	9	0	0	9
val_AA10.2_batch1	PKU	39	0	0	39
val_AA10.2_batch1	SCAD	9	8	0	17
val_AA10.2_batch1	TFP	1	0	0	1
val_AA10.2_batch1	VLCAD	5	0	0	5
test_AA10.4_filter2	3MCC	16	9	1	26
test_AA10.4_filter2	ARG	3	0	0	3
test_AA10.4_filter2	BKT	2	0	0	2
test_AA10.4_filter2	CIT	20	2	0	22
test_AA10.4_filter2	CPT I	1	0	0	1
test_AA10.4_filter2	CPT II	5	3	0	8
test_AA10.4_filter2	CTD	23	8	2	33
test_AA10.4_filter2	GA-I	26	4	0	30
test_AA10.4_filter2	GA2	6	1	0	7
test_AA10.4_filter2	HCY	5	2	2	9
test_AA10.4_filter2	HYPRO	0	2	0	2
test_AA10.4_filter2	IVA	25	5	1	31
test_AA10.4_filter2	LCHAD	9	0	0	9
test_AA10.4_filter2	MAL	2	4	0	6
test_AA10.4_filter2	MCAD	123	13	2	138
test_AA10.4_filter2	MCD	1	2	0	3
test_AA10.4_filter2	MSUD	20	2	0	22
test_AA10.4_filter2	OTC	8	1	0	9
test_AA10.4_filter2	PA/MMA	56	13	1	70
test_AA10.4_filter2	PKU	71	5	0	76
test_AA10.4_filter2	RMD	1	0	0	1
test_AA10.4_filter2	SCAD	28	30	2	60
test_AA10.4_filter2	TFP	3	0	0	3
test_AA10.4_filter2	TYRO1	6	0	0	6
test_AA10.4_filter2	VLCAD	28	8	0	36
AA10.2	3MCC	33	11	1	45
AA10.2	ARG	4	0	0	4
AA10.2	BKT	3	0	0	3
AA10.2	CIT	28	5	0	33
AA10.2	CPT I	1	0	0	1
AA10.2	CPT II	5	3	0	8
AA10.2	CTD	36	9	2	47
AA10.2	GA-I	31	4	1	36
AA10.2	GA2	9	3	0	12
AA10.2	HCY	9	2	1	12
AA10.2	HYPRO	0	3	0	3
AA10.2	IVA	34	5	1	40
AA10.2	LCHAD	9	0	0	9
AA10.2	MAL	2	4	0	6
AA10.2	MCAD	162	11	1	174
AA10.2	MCD	2	3	0	5
AA10.2	MSUD	22	3	0	25
AA10.2	OTC	13	3	0	16
AA10.2	PA/MMA	74	15	1	90
AA10.2	PKU	123	8	0	131
AA10.2	RMD	3	0	0	3
AA10.2	SCAD	40	41	3	84
AA10.2	TFP	4	0	0	4
AA10.2	TYRO1	7	0	0	7
AA10.2	VLCAD	41	6	0	47
test_AA10.7_filter1	3MCC	7	20	0	27
test_AA10.7_filter1	ARG	1	2	0	3
test_AA10.7_filter1	BKT	0	2	0	2
test_AA10.7_filter1	CIT	12	11	0	23
test_AA10.7_filter1	CPT I	1	0	0	1
test_AA10.7_filter1	CPT II	3	5	0	8
test_AA10.7_filter1	CTD	16	16	2	34
test_AA10.7_filter1	GA-I	17	14	0	31
test_AA10.7_filter1	GA2	3	4	0	7
test_AA10.7_filter1	HCY	4	5	1	10
test_AA10.7_filter1	HYPRO	0	2	0	2
test_AA10.7_filter1	IVA	14	17	2	33
test_AA10.7_filter1	LCHAD	5	4	0	9
test_AA10.7_filter1	MAL	1	5	0	6
test_AA10.7_filter1	MCAD	79	62	2	143
test_AA10.7_filter1	MCD	1	2	0	3
test_AA10.7_filter1	MSUD	8	14	0	22
test_AA10.7_filter1	OTC	7	2	0	9
test_AA10.7_filter1	PA/MMA	48	25	0	73
test_AA10.7_filter1	PKU	72	7	0	79
test_AA10.7_filter1	RMD	1	0	0	1
test_AA10.7_filter1	SCAD	15	46	2	63
test_AA10.7_filter1	TFP	1	2	0	3
test_AA10.7_filter1	TYRO1	6	1	0	7
test_AA10.7_filter1	VLCAD	18	21	0	39
val_AA10.7_filter2	3MCC	3	12	0	15
val_AA10.7_filter2	BKT	0	1	0	1
val_AA10.7_filter2	CIT	3	3	0	6
val_AA10.7_filter2	CTD	7	2	0	9
val_AA10.7_filter2	GA-I	0	1	0	1
val_AA10.7_filter2	GA2	2	2	0	4
val_AA10.7_filter2	HCY	1	0	0	1
val_AA10.7_filter2	IVA	1	2	0	3
val_AA10.7_filter2	MCAD	5	12	0	17
val_AA10.7_filter2	MCD	0	1	0	1
val_AA10.7_filter2	MSUD	1	2	0	3
val_AA10.7_filter2	OTC	1	4	0	5
val_AA10.7_filter2	PA/MMA	6	3	0	9
val_AA10.7_filter2	PKU	37	2	0	39
val_AA10.7_filter2	SCAD	6	11	0	17
val_AA10.7_filter2	TFP	0	1	0	1
val_AA10.7_filter2	VLCAD	3	2	0	5
val_AA10.5	3MCC	3	12	0	15
val_AA10.5	BKT	0	1	0	1
val_AA10.5	CIT	4	3	0	7
val_AA10.5	CTD	7	2	0	9
val_AA10.5	GA-I	0	1	0	1
val_AA10.5	GA2	2	2	0	4
val_AA10.5	HCY	1	0	0	1
val_AA10.5	IVA	3	0	0	3
val_AA10.5	MCAD	5	12	0	17
val_AA10.5	MCD	0	1	0	1
val_AA10.5	MSUD	1	2	0	3
val_AA10.5	OTC	2	3	0	5
val_AA10.5	PA/MMA	7	2	0	9
val_AA10.5	PKU	37	2	0	39
val_AA10.5	SCAD	6	11	0	17
val_AA10.5	TFP	0	1	0	1
val_AA10.5	VLCAD	3	2	0	5
AA10.8_filter1	3MCC	10	32	0	42
AA10.8_filter1	ARG	1	2	0	3
AA10.8_filter1	BKT	0	3	0	3
AA10.8_filter1	CIT	15	14	0	29
AA10.8_filter1	CPT I	1	0	0	1
AA10.8_filter1	CPT II	3	5	0	8
AA10.8_filter1	CTD	20	22	1	43
AA10.8_filter1	GA-I	17	15	0	32
AA10.8_filter1	GA2	5	6	0	11
AA10.8_filter1	HCY	2	8	1	11
AA10.8_filter1	HYPRO	0	2	0	2
AA10.8_filter1	IVA	15	20	1	36
AA10.8_filter1	LCHAD	5	4	0	9
AA10.8_filter1	MAL	1	5	0	6
AA10.8_filter1	MCAD	83	77	0	160
AA10.8_filter1	MCD	1	3	0	4
AA10.8_filter1	MSUD	9	16	0	25
AA10.8_filter1	OTC	8	6	0	14
AA10.8_filter1	PA/MMA	52	30	0	82
AA10.8_filter1	PKU	106	12	0	118
AA10.8_filter1	RMD	1	0	0	1
AA10.8_filter1	SCAD	8	72	0	80
AA10.8_filter1	TFP	1	3	0	4
AA10.8_filter1	TYRO1	6	1	0	7
AA10.8_filter1	VLCAD	21	23	0	44
test_AA10.5_batch3	3MCC	6	11	0	17
test_AA10.5_batch3	ARG	1	1	0	2
test_AA10.5_batch3	BKT	0	2	0	2
test_AA10.5_batch3	CIT	9	8	0	17
test_AA10.5_batch3	CPT II	3	4	0	7
test_AA10.5_batch3	CTD	12	16	2	30
test_AA10.5_batch3	GA-I	14	12	1	27
test_AA10.5_batch3	GA2	3	3	0	6
test_AA10.5_batch3	HCY	4	5	1	10
test_AA10.5_batch3	HYPRO	0	3	0	3
test_AA10.5_batch3	IVA	11	12	1	24
test_AA10.5_batch3	LCHAD	4	3	0	7
test_AA10.5_batch3	MAL	1	4	0	5
test_AA10.5_batch3	MCAD	64	50	3	117
test_AA10.5_batch3	MCD	1	3	0	4
test_AA10.5_batch3	MSUD	8	11	0	19
test_AA10.5_batch3	OTC	4	0	0	4
test_AA10.5_batch3	PA/MMA	43	24	0	67
test_AA10.5_batch3	PKU	25	6	0	31
test_AA10.5_batch3	SCAD	11	24	1	36
test_AA10.5_batch3	TFP	1	1	0	2
test_AA10.5_batch3	TYRO1	5	1	0	6
test_AA10.5_batch3	VLCAD	19	18	0	37
val_AA10.6.NonSyn.005	3MCC	8	7	0	15
val_AA10.6.NonSyn.005	BKT	1	0	0	1
val_AA10.6.NonSyn.005	CIT	3	3	1	7
val_AA10.6.NonSyn.005	CTD	4	4	1	9
val_AA10.6.NonSyn.005	GA-I	1	0	0	1
val_AA10.6.NonSyn.005	GA2	3	1	0	4
val_AA10.6.NonSyn.005	HCY	0	1	0	1
val_AA10.6.NonSyn.005	IVA	1	2	0	3
val_AA10.6.NonSyn.005	MCAD	14	3	0	17
val_AA10.6.NonSyn.005	MCD	0	1	0	1
val_AA10.6.NonSyn.005	MSUD	1	1	1	3
val_AA10.6.NonSyn.005	OTC	3	2	0	5
val_AA10.6.NonSyn.005	PA/MMA	3	6	0	9
val_AA10.6.NonSyn.005	PKU	22	17	0	39
val_AA10.6.NonSyn.005	SCAD	8	9	0	17
val_AA10.6.NonSyn.005	TFP	0	1	0	1
val_AA10.6.NonSyn.005	VLCAD	2	3	0	5
AA10.2_filter3	3MCC	25	7	1	33
AA10.2_filter3	ARG	3	0	0	3
AA10.2_filter3	BKT	2	0	0	2
AA10.2_filter3	CIT	23	4	0	27
AA10.2_filter3	CPT I	1	0	0	1
AA10.2_filter3	CPT II	3	3	0	6
AA10.2_filter3	CTD	29	7	2	38
AA10.2_filter3	GA-I	24	4	0	28
AA10.2_filter3	GA2	8	1	0	9
AA10.2_filter3	HCY	7	1	1	9
AA10.2_filter3	HYPRO	0	2	0	2
AA10.2_filter3	IVA	24	4	1	29
AA10.2_filter3	LCHAD	7	0	0	7
AA10.2_filter3	MAL	2	4	0	6
AA10.2_filter3	MCAD	128	11	1	140
AA10.2_filter3	MCD	2	2	0	4
AA10.2_filter3	MSUD	18	2	0	20
AA10.2_filter3	OTC	9	0	0	9
AA10.2_filter3	PA/MMA	60	12	1	73
AA10.2_filter3	PKU	83	5	0	88
AA10.2_filter3	SCAD	33	32	2	67
AA10.2_filter3	TFP	4	0	0	4
AA10.2_filter3	TYRO1	6	0	0	6
AA10.2_filter3	VLCAD	33	6	0	39
val_AA10.6.NonSyn.005_batch1	3MCC	8	7	0	15
val_AA10.6.NonSyn.005_batch1	BKT	1	0	0	1
val_AA10.6.NonSyn.005_batch1	CIT	3	3	1	7
val_AA10.6.NonSyn.005_batch1	CTD	4	4	1	9
val_AA10.6.NonSyn.005_batch1	GA-I	1	0	0	1
val_AA10.6.NonSyn.005_batch1	GA2	3	1	0	4
val_AA10.6.NonSyn.005_batch1	HCY	0	1	0	1
val_AA10.6.NonSyn.005_batch1	IVA	1	2	0	3
val_AA10.6.NonSyn.005_batch1	MCAD	14	3	0	17
val_AA10.6.NonSyn.005_batch1	MCD	0	1	0	1
val_AA10.6.NonSyn.005_batch1	MSUD	1	1	1	3
val_AA10.6.NonSyn.005_batch1	OTC	3	2	0	5
val_AA10.6.NonSyn.005_batch1	PA/MMA	3	6	0	9
val_AA10.6.NonSyn.005_batch1	PKU	22	17	0	39
val_AA10.6.NonSyn.005_batch1	SCAD	8	9	0	17
val_AA10.6.NonSyn.005_batch1	TFP	0	1	0	1
val_AA10.6.NonSyn.005_batch1	VLCAD	2	3	0	5
test_AA10.6_filter1	3MCC	17	9	1	27
test_AA10.6_filter1	ARG	3	0	0	3
test_AA10.6_filter1	BKT	2	0	0	2
test_AA10.6_filter1	CIT	21	2	0	23
test_AA10.6_filter1	CPT I	1	0	0	1
test_AA10.6_filter1	CPT II	5	3	0	8
test_AA10.6_filter1	CTD	24	8	2	34
test_AA10.6_filter1	GA-I	27	4	0	31
test_AA10.6_filter1	GA2	6	1	0	7
test_AA10.6_filter1	HCY	6	2	2	10
test_AA10.6_filter1	HYPRO	0	2	0	2
test_AA10.6_filter1	IVA	26	6	1	33
test_AA10.6_filter1	LCHAD	9	0	0	9
test_AA10.6_filter1	MAL	2	4	0	6
test_AA10.6_filter1	MCAD	126	16	1	143
test_AA10.6_filter1	MCD	1	2	0	3
test_AA10.6_filter1	MSUD	18	3	1	22
test_AA10.6_filter1	OTC	8	1	0	9
test_AA10.6_filter1	PA/MMA	58	14	1	73
test_AA10.6_filter1	PKU	73	6	0	79
test_AA10.6_filter1	RMD	1	0	0	1
test_AA10.6_filter1	SCAD	31	30	2	63
test_AA10.6_filter1	TFP	3	0	0	3
test_AA10.6_filter1	TYRO1	7	0	0	7
test_AA10.6_filter1	VLCAD	31	8	0	39
test_AA10.8_batch2	3MCC	2	11	0	13
test_AA10.8_batch2	ARG	1	1	0	2
test_AA10.8_batch2	CIT	5	4	0	9
test_AA10.8_batch2	CPT I	1	0	0	1
test_AA10.8_batch2	CPT II	0	1	0	1
test_AA10.8_batch2	CTD	2	6	0	8
test_AA10.8_batch2	GA-I	6	2	0	8
test_AA10.8_batch2	GA2	0	2	0	2
test_AA10.8_batch2	HCY	0	1	0	1
test_AA10.8_batch2	IVA	7	6	0	13
test_AA10.8_batch2	LCHAD	1	1	0	2
test_AA10.8_batch2	MAL	0	1	0	1
test_AA10.8_batch2	MCAD	23	17	0	40
test_AA10.8_batch2	MSUD	2	1	0	3
test_AA10.8_batch2	OTC	3	4	0	7
test_AA10.8_batch2	PA/MMA	11	3	0	14
test_AA10.8_batch2	PKU	58	3	0	61
test_AA10.8_batch2	RMD	3	0	0	3
test_AA10.8_batch2	SCAD	4	27	0	31
test_AA10.8_batch2	TFP	0	1	0	1
test_AA10.8_batch2	TYRO1	1	0	0	1
test_AA10.8_batch2	VLCAD	1	4	0	5
test_AA10.3	3MCC	19	10	1	30
test_AA10.3	ARG	4	0	0	4
test_AA10.3	BKT	2	0	0	2
test_AA10.3	CIT	23	3	0	26
test_AA10.3	CPT I	1	0	0	1
test_AA10.3	CPT II	5	3	0	8
test_AA10.3	CTD	27	9	2	38
test_AA10.3	GA-I	30	4	1	35
test_AA10.3	GA2	6	2	0	8
test_AA10.3	HCY	8	2	1	11
test_AA10.3	HYPRO	0	3	0	3
test_AA10.3	IVA	30	6	1	37
test_AA10.3	LCHAD	9	0	0	9
test_AA10.3	MAL	2	4	0	6
test_AA10.3	MCAD	145	12	0	157
test_AA10.3	MCD	1	3	0	4
test_AA10.3	MSUD	19	3	0	22
test_AA10.3	OTC	9	2	0	11
test_AA10.3	PA/MMA	64	16	1	81
test_AA10.3	PKU	84	8	0	92
test_AA10.3	RMD	3	0	0	3
test_AA10.3	SCAD	31	33	3	67
test_AA10.3	TFP	3	0	0	3
test_AA10.3	TYRO1	7	0	0	7
test_AA10.3	VLCAD	36	6	0	42
AA10.6_filter3	3MCC	25	7	1	33
AA10.6_filter3	ARG	3	0	0	3
AA10.6_filter3	BKT	2	0	0	2
AA10.6_filter3	CIT	23	4	0	27
AA10.6_filter3	CPT I	1	0	0	1
AA10.6_filter3	CPT II	3	3	0	6
AA10.6_filter3	CTD	28	8	2	38
AA10.6_filter3	GA-I	24	4	0	28
AA10.6_filter3	GA2	8	1	0	9
AA10.6_filter3	HCY	5	3	1	9
AA10.6_filter3	HYPRO	0	2	0	2
AA10.6_filter3	IVA	21	7	1	29
AA10.6_filter3	LCHAD	7	0	0	7
AA10.6_filter3	MAL	2	4	0	6
AA10.6_filter3	MCAD	123	16	1	140
AA10.6_filter3	MCD	2	2	0	4
AA10.6_filter3	MSUD	17	3	0	20
AA10.6_filter3	OTC	8	1	0	9
AA10.6_filter3	PA/MMA	57	15	1	73
AA10.6_filter3	PKU	82	6	0	88
AA10.6_filter3	SCAD	33	33	1	67
AA10.6_filter3	TFP	4	0	0	4
AA10.6_filter3	TYRO1	6	0	0	6
AA10.6_filter3	VLCAD	31	8	0	39
AA10.4_filter2	3MCC	30	10	1	41
AA10.4_filter2	ARG	3	0	0	3
AA10.4_filter2	BKT	3	0	0	3
AA10.4_filter2	CIT	24	4	0	28
AA10.4_filter2	CPT I	1	0	0	1
AA10.4_filter2	CPT II	5	3	0	8
AA10.4_filter2	CTD	32	8	2	42
AA10.4_filter2	GA-I	27	4	0	31
AA10.4_filter2	GA2	9	2	0	11
AA10.4_filter2	HCY	5	3	2	10
AA10.4_filter2	HYPRO	0	2	0	2
AA10.4_filter2	IVA	28	5	1	34
AA10.4_filter2	LCHAD	9	0	0	9
AA10.4_filter2	MAL	2	4	0	6
AA10.4_filter2	MCAD	139	14	2	155
AA10.4_filter2	MCD	2	2	0	4
AA10.4_filter2	MSUD	21	3	1	25
AA10.4_filter2	OTC	12	2	0	14
AA10.4_filter2	PA/MMA	64	14	1	79
AA10.4_filter2	PKU	108	7	0	115
AA10.4_filter2	RMD	1	0	0	1
AA10.4_filter2	SCAD	37	38	2	77
AA10.4_filter2	TFP	4	0	0	4
AA10.4_filter2	TYRO1	6	0	0	6
AA10.4_filter2	VLCAD	32	9	0	41
AA10.2_filter4	3MCC	20	4	0	24
AA10.2_filter4	ARG	1	0	0	1
AA10.2_filter4	BKT	2	0	0	2
AA10.2_filter4	CIT	16	3	0	19
AA10.2_filter4	CPT II	3	3	0	6
AA10.2_filter4	CTD	25	6	2	33
AA10.2_filter4	GA-I	21	3	0	24
AA10.2_filter4	GA2	7	0	0	7
AA10.2_filter4	HCY	6	1	1	8
AA10.2_filter4	HYPRO	0	1	0	1
AA10.2_filter4	IVA	17	4	1	22
AA10.2_filter4	LCHAD	6	0	0	6
AA10.2_filter4	MAL	2	1	0	3
AA10.2_filter4	MCAD	98	10	1	109
AA10.2_filter4	MCD	2	2	0	4
AA10.2_filter4	MSUD	10	2	0	12
AA10.2_filter4	OTC	8	0	0	8
AA10.2_filter4	PA/MMA	49	11	1	61
AA10.2_filter4	PKU	53	4	0	57
AA10.2_filter4	SCAD	29	16	1	46
AA10.2_filter4	TFP	4	0	0	4
AA10.2_filter4	TYRO1	6	0	0	6
AA10.2_filter4	VLCAD	25	6	0	31
test_AA10.1_filter2	3MCC	16	9	1	26
test_AA10.1_filter2	ARG	3	0	0	3
test_AA10.1_filter2	BKT	2	0	0	2
test_AA10.1_filter2	CIT	20	2	0	22
test_AA10.1_filter2	CPT I	1	0	0	1
test_AA10.1_filter2	CPT II	5	3	0	8
test_AA10.1_filter2	CTD	24	7	2	33
test_AA10.1_filter2	GA-I	26	4	0	30
test_AA10.1_filter2	GA2	6	1	0	7
test_AA10.1_filter2	HCY	7	1	1	9
test_AA10.1_filter2	HYPRO	0	2	0	2
test_AA10.1_filter2	IVA	25	5	1	31
test_AA10.1_filter2	LCHAD	9	0	0	9
test_AA10.1_filter2	MAL	2	4	0	6
test_AA10.1_filter2	MCAD	127	10	1	138
test_AA10.1_filter2	MCD	1	2	0	3
test_AA10.1_filter2	MSUD	19	3	0	22
test_AA10.1_filter2	OTC	8	1	0	9
test_AA10.1_filter2	PA/MMA	56	13	1	70
test_AA10.1_filter2	PKU	71	5	0	76
test_AA10.1_filter2	RMD	1	0	0	1
test_AA10.1_filter2	SCAD	28	29	3	60
test_AA10.1_filter2	TFP	3	0	0	3
test_AA10.1_filter2	TYRO1	6	0	0	6
test_AA10.1_filter2	VLCAD	30	6	0	36
AA10.1_filter1	3MCC	31	10	1	42
AA10.1_filter1	ARG	3	0	0	3
AA10.1_filter1	BKT	3	0	0	3
AA10.1_filter1	CIT	25	4	0	29
AA10.1_filter1	CPT I	1	0	0	1
AA10.1_filter1	CPT II	5	3	0	8
AA10.1_filter1	CTD	34	7	2	43
AA10.1_filter1	GA-I	28	4	0	32
AA10.1_filter1	GA2	9	2	0	11
AA10.1_filter1	HCY	9	1	1	11
AA10.1_filter1	HYPRO	0	2	0	2
AA10.1_filter1	IVA	30	5	1	36
AA10.1_filter1	LCHAD	9	0	0	9
AA10.1_filter1	MAL	2	4	0	6
AA10.1_filter1	MCAD	148	11	1	160
AA10.1_filter1	MCD	2	2	0	4
AA10.1_filter1	MSUD	21	4	0	25
AA10.1_filter1	OTC	12	2	0	14
AA10.1_filter1	PA/MMA	68	13	1	82
AA10.1_filter1	PKU	112	6	0	118
AA10.1_filter1	RMD	1	0	0	1
AA10.1_filter1	SCAD	40	37	3	80
AA10.1_filter1	TFP	4	0	0	4
AA10.1_filter1	TYRO1	7	0	0	7
AA10.1_filter1	VLCAD	38	6	0	44
val_AA10.6_filter4	3MCC	11	0	0	11
val_AA10.6_filter4	CIT	3	2	0	5
val_AA10.6_filter4	CTD	9	0	0	9
val_AA10.6_filter4	GA-I	1	0	0	1
val_AA10.6_filter4	GA2	2	0	0	2
val_AA10.6_filter4	HCY	0	1	0	1
val_AA10.6_filter4	IVA	0	2	0	2
val_AA10.6_filter4	MCAD	11	1	0	12
val_AA10.6_filter4	MCD	1	0	0	1
val_AA10.6_filter4	MSUD	1	1	0	2
val_AA10.6_filter4	OTC	2	1	0	3
val_AA10.6_filter4	PA/MMA	7	2	0	9
val_AA10.6_filter4	PKU	31	1	0	32
val_AA10.6_filter4	SCAD	8	7	0	15
val_AA10.6_filter4	TFP	1	0	0	1
val_AA10.6_filter4	VLCAD	4	0	0	4
val_AA10.6.NonSyn.005_filter1	3MCC	8	7	0	15
val_AA10.6.NonSyn.005_filter1	BKT	1	0	0	1
val_AA10.6.NonSyn.005_filter1	CIT	2	3	1	6
val_AA10.6.NonSyn.005_filter1	CTD	4	4	1	9
val_AA10.6.NonSyn.005_filter1	GA-I	1	0	0	1
val_AA10.6.NonSyn.005_filter1	GA2	3	1	0	4
val_AA10.6.NonSyn.005_filter1	HCY	0	1	0	1
val_AA10.6.NonSyn.005_filter1	IVA	1	2	0	3
val_AA10.6.NonSyn.005_filter1	MCAD	14	3	0	17
val_AA10.6.NonSyn.005_filter1	MCD	0	1	0	1
val_AA10.6.NonSyn.005_filter1	MSUD	1	1	1	3
val_AA10.6.NonSyn.005_filter1	OTC	3	2	0	5
val_AA10.6.NonSyn.005_filter1	PA/MMA	3	6	0	9
val_AA10.6.NonSyn.005_filter1	PKU	22	17	0	39
val_AA10.6.NonSyn.005_filter1	SCAD	8	9	0	17
val_AA10.6.NonSyn.005_filter1	TFP	0	1	0	1
val_AA10.6.NonSyn.005_filter1	VLCAD	2	3	0	5
AA10.1_filter4	3MCC	20	4	0	24
AA10.1_filter4	ARG	1	0	0	1
AA10.1_filter4	BKT	2	0	0	2
AA10.1_filter4	CIT	16	3	0	19
AA10.1_filter4	CPT II	3	3	0	6
AA10.1_filter4	CTD	25	6	2	33
AA10.1_filter4	GA-I	21	3	0	24
AA10.1_filter4	GA2	7	0	0	7
AA10.1_filter4	HCY	6	1	1	8
AA10.1_filter4	HYPRO	0	1	0	1
AA10.1_filter4	IVA	17	4	1	22
AA10.1_filter4	LCHAD	6	0	0	6
AA10.1_filter4	MAL	2	1	0	3
AA10.1_filter4	MCAD	98	10	1	109
AA10.1_filter4	MCD	2	2	0	4
AA10.1_filter4	MSUD	10	2	0	12
AA10.1_filter4	OTC	8	0	0	8
AA10.1_filter4	PA/MMA	49	11	1	61
AA10.1_filter4	PKU	53	4	0	57
AA10.1_filter4	SCAD	29	16	1	46
AA10.1_filter4	TFP	4	0	0	4
AA10.1_filter4	TYRO1	6	0	0	6
AA10.1_filter4	VLCAD	25	6	0	31
val_AA10.8_filter4	3MCC	3	8	0	11
val_AA10.8_filter4	CIT	3	2	0	5
val_AA10.8_filter4	CTD	5	4	0	9
val_AA10.8_filter4	GA-I	0	1	0	1
val_AA10.8_filter4	GA2	1	1	0	2
val_AA10.8_filter4	HCY	0	1	0	1
val_AA10.8_filter4	IVA	0	2	0	2
val_AA10.8_filter4	MCAD	4	8	0	12
val_AA10.8_filter4	MCD	0	1	0	1
val_AA10.8_filter4	MSUD	0	2	0	2
val_AA10.8_filter4	OTC	1	2	0	3
val_AA10.8_filter4	PA/MMA	5	4	0	9
val_AA10.8_filter4	PKU	29	3	0	32
val_AA10.8_filter4	SCAD	2	13	0	15
val_AA10.8_filter4	TFP	0	1	0	1
val_AA10.8_filter4	VLCAD	2	2	0	4
test_AA10.6.NonSyn.02_batch2	3MCC	6	5	2	13
test_AA10.6.NonSyn.02_batch2	ARG	0	1	1	2
test_AA10.6.NonSyn.02_batch2	CIT	6	2	1	9
test_AA10.6.NonSyn.02_batch2	CPT I	0	1	0	1
test_AA10.6.NonSyn.02_batch2	CPT II	0	1	0	1
test_AA10.6.NonSyn.02_batch2	CTD	6	2	0	8
test_AA10.6.NonSyn.02_batch2	GA-I	5	3	0	8
test_AA10.6.NonSyn.02_batch2	GA2	0	2	0	2
test_AA10.6.NonSyn.02_batch2	HCY	1	0	0	1
test_AA10.6.NonSyn.02_batch2	IVA	10	2	1	13
test_AA10.6.NonSyn.02_batch2	LCHAD	0	1	1	2
test_AA10.6.NonSyn.02_batch2	MAL	0	1	0	1
test_AA10.6.NonSyn.02_batch2	MCAD	32	8	0	40
test_AA10.6.NonSyn.02_batch2	MSUD	2	1	0	3
test_AA10.6.NonSyn.02_batch2	OTC	3	4	0	7
test_AA10.6.NonSyn.02_batch2	PA/MMA	4	9	1	14
test_AA10.6.NonSyn.02_batch2	PKU	27	33	1	61
test_AA10.6.NonSyn.02_batch2	RMD	1	2	0	3
test_AA10.6.NonSyn.02_batch2	SCAD	7	22	2	31
test_AA10.6.NonSyn.02_batch2	TFP	0	1	0	1
test_AA10.6.NonSyn.02_batch2	TYRO1	1	0	0	1
test_AA10.6.NonSyn.02_batch2	VLCAD	2	3	0	5
AA10.8_filter3	3MCC	8	25	0	33
AA10.8_filter3	ARG	1	2	0	3
AA10.8_filter3	BKT	0	2	0	2
AA10.8_filter3	CIT	14	13	0	27
AA10.8_filter3	CPT I	1	0	0	1
AA10.8_filter3	CPT II	2	4	0	6
AA10.8_filter3	CTD	18	19	1	38
AA10.8_filter3	GA-I	13	15	0	28
AA10.8_filter3	GA2	4	5	0	9
AA10.8_filter3	HCY	2	6	1	9
AA10.8_filter3	HYPRO	0	2	0	2
AA10.8_filter3	IVA	12	16	1	29
AA10.8_filter3	LCHAD	4	3	0	7
AA10.8_filter3	MAL	1	5	0	6
AA10.8_filter3	MCAD	71	69	0	140
AA10.8_filter3	MCD	1	3	0	4
AA10.8_filter3	MSUD	5	15	0	20
AA10.8_filter3	OTC	7	2	0	9
AA10.8_filter3	PA/MMA	45	28	0	73
AA10.8_filter3	PKU	77	11	0	88
AA10.8_filter3	SCAD	4	63	0	67
AA10.8_filter3	TFP	1	3	0	4
AA10.8_filter3	TYRO1	5	1	0	6
AA10.8_filter3	VLCAD	19	20	0	39
test_AA10.3_batch3	3MCC	13	4	0	17
test_AA10.3_batch3	ARG	2	0	0	2
test_AA10.3_batch3	BKT	2	0	0	2
test_AA10.3_batch3	CIT	16	1	0	17
test_AA10.3_batch3	CPT II	5	2	0	7
test_AA10.3_batch3	CTD	20	8	2	30
test_AA10.3_batch3	GA-I	22	4	1	27
test_AA10.3_batch3	GA2	5	1	0	6
test_AA10.3_batch3	HCY	7	2	1	10
test_AA10.3_batch3	HYPRO	0	3	0	3
test_AA10.3_batch3	IVA	17	6	1	24
test_AA10.3_batch3	LCHAD	7	0	0	7
test_AA10.3_batch3	MAL	2	3	0	5
test_AA10.3_batch3	MCAD	105	12	0	117
test_AA10.3_batch3	MCD	1	3	0	4
test_AA10.3_batch3	MSUD	16	3	0	19
test_AA10.3_batch3	OTC	4	0	0	4
test_AA10.3_batch3	PA/MMA	51	15	1	67
test_AA10.3_batch3	PKU	25	6	0	31
test_AA10.3_batch3	SCAD	22	12	2	36
test_AA10.3_batch3	TFP	2	0	0	2
test_AA10.3_batch3	TYRO1	6	0	0	6
test_AA10.3_batch3	VLCAD	31	6	0	37
test_AA10.6.NonSyn.005_filter2	3MCC	10	15	1	26
test_AA10.6.NonSyn.005_filter2	ARG	1	1	1	3
test_AA10.6.NonSyn.005_filter2	BKT	0	2	0	2
test_AA10.6.NonSyn.005_filter2	CIT	15	7	0	22
test_AA10.6.NonSyn.005_filter2	CPT I	0	1	0	1
test_AA10.6.NonSyn.005_filter2	CPT II	1	7	0	8
test_AA10.6.NonSyn.005_filter2	CTD	15	16	2	33
test_AA10.6.NonSyn.005_filter2	GA-I	19	11	0	30
test_AA10.6.NonSyn.005_filter2	GA2	4	3	0	7
test_AA10.6.NonSyn.005_filter2	HCY	4	3	2	9
test_AA10.6.NonSyn.005_filter2	HYPRO	0	2	0	2
test_AA10.6.NonSyn.005_filter2	IVA	16	13	2	31
test_AA10.6.NonSyn.005_filter2	LCHAD	2	7	0	9
test_AA10.6.NonSyn.005_filter2	MAL	1	5	0	6
test_AA10.6.NonSyn.005_filter2	MCAD	103	34	1	138
test_AA10.6.NonSyn.005_filter2	MCD	1	2	0	3
test_AA10.6.NonSyn.005_filter2	MSUD	12	9	1	22
test_AA10.6.NonSyn.005_filter2	OTC	6	3	0	9
test_AA10.6.NonSyn.005_filter2	PA/MMA	17	51	2	70
test_AA10.6.NonSyn.005_filter2	PKU	36	39	1	76
test_AA10.6.NonSyn.005_filter2	RMD	1	0	0	1
test_AA10.6.NonSyn.005_filter2	SCAD	22	37	1	60
test_AA10.6.NonSyn.005_filter2	TFP	1	2	0	3
test_AA10.6.NonSyn.005_filter2	TYRO1	3	3	0	6
test_AA10.6.NonSyn.005_filter2	VLCAD	19	17	0	36
AA10.3	3MCC	33	11	1	45
AA10.3	ARG	4	0	0	4
AA10.3	BKT	3	0	0	3
AA10.3	CIT	28	5	0	33
AA10.3	CPT I	1	0	0	1
AA10.3	CPT II	5	3	0	8
AA10.3	CTD	36	9	2	47
AA10.3	GA-I	31	4	1	36
AA10.3	GA2	9	3	0	12
AA10.3	HCY	9	2	1	12
AA10.3	HYPRO	0	3	0	3
AA10.3	IVA	31	8	1	40
AA10.3	LCHAD	9	0	0	9
AA10.3	MAL	2	4	0	6
AA10.3	MCAD	161	13	0	174
AA10.3	MCD	2	3	0	5
AA10.3	MSUD	21	4	0	25
AA10.3	OTC	12	4	0	16
AA10.3	PA/MMA	72	17	1	90
AA10.3	PKU	123	8	0	131
AA10.3	RMD	3	0	0	3
AA10.3	SCAD	40	41	3	84
AA10.3	TFP	4	0	0	4
AA10.3	TYRO1	7	0	0	7
AA10.3	VLCAD	41	6	0	47
val_AA10.6.NonSyn.02_filter2	3MCC	8	7	0	15
val_AA10.6.NonSyn.02_filter2	BKT	1	0	0	1
val_AA10.6.NonSyn.02_filter2	CIT	2	3	1	6
val_AA10.6.NonSyn.02_filter2	CTD	4	4	1	9
val_AA10.6.NonSyn.02_filter2	GA-I	1	0	0	1
val_AA10.6.NonSyn.02_filter2	GA2	3	1	0	4
val_AA10.6.NonSyn.02_filter2	HCY	0	1	0	1
val_AA10.6.NonSyn.02_filter2	IVA	1	1	1	3
val_AA10.6.NonSyn.02_filter2	MCAD	14	3	0	17
val_AA10.6.NonSyn.02_filter2	MCD	0	1	0	1
val_AA10.6.NonSyn.02_filter2	MSUD	1	1	1	3
val_AA10.6.NonSyn.02_filter2	OTC	3	2	0	5
val_AA10.6.NonSyn.02_filter2	PA/MMA	4	5	0	9
val_AA10.6.NonSyn.02_filter2	PKU	22	16	1	39
val_AA10.6.NonSyn.02_filter2	SCAD	8	9	0	17
val_AA10.6.NonSyn.02_filter2	TFP	0	1	0	1
val_AA10.6.NonSyn.02_filter2	VLCAD	2	3	0	5
test_AA10.7_filter2	3MCC	6	20	0	26
test_AA10.7_filter2	ARG	1	2	0	3
test_AA10.7_filter2	BKT	0	2	0	2
test_AA10.7_filter2	CIT	11	11	0	22
test_AA10.7_filter2	CPT I	1	0	0	1
test_AA10.7_filter2	CPT II	3	5	0	8
test_AA10.7_filter2	CTD	15	16	2	33
test_AA10.7_filter2	GA-I	16	14	0	30
test_AA10.7_filter2	GA2	3	4	0	7
test_AA10.7_filter2	HCY	4	4	1	9
test_AA10.7_filter2	HYPRO	0	2	0	2
test_AA10.7_filter2	IVA	12	17	2	31
test_AA10.7_filter2	LCHAD	5	4	0	9
test_AA10.7_filter2	MAL	1	5	0	6
test_AA10.7_filter2	MCAD	75	61	2	138
test_AA10.7_filter2	MCD	1	2	0	3
test_AA10.7_filter2	MSUD	8	14	0	22
test_AA10.7_filter2	OTC	7	2	0	9
test_AA10.7_filter2	PA/MMA	46	24	0	70
test_AA10.7_filter2	PKU	70	6	0	76
test_AA10.7_filter2	RMD	1	0	0	1
test_AA10.7_filter2	SCAD	14	44	2	60
test_AA10.7_filter2	TFP	1	2	0	3
test_AA10.7_filter2	TYRO1	5	1	0	6
test_AA10.7_filter2	VLCAD	18	18	0	36
val_AA10.2_filter1	3MCC	14	1	0	15
val_AA10.2_filter1	BKT	1	0	0	1
val_AA10.2_filter1	CIT	4	2	0	6
val_AA10.2_filter1	CTD	9	0	0	9
val_AA10.2_filter1	GA-I	1	0	0	1
val_AA10.2_filter1	GA2	3	1	0	4
val_AA10.2_filter1	HCY	1	0	0	1
val_AA10.2_filter1	IVA	3	0	0	3
val_AA10.2_filter1	MCAD	16	1	0	17
val_AA10.2_filter1	MCD	1	0	0	1
val_AA10.2_filter1	MSUD	2	1	0	3
val_AA10.2_filter1	OTC	4	1	0	5
val_AA10.2_filter1	PA/MMA	9	0	0	9
val_AA10.2_filter1	PKU	39	0	0	39
val_AA10.2_filter1	SCAD	9	8	0	17
val_AA10.2_filter1	TFP	1	0	0	1
val_AA10.2_filter1	VLCAD	5	0	0	5
test_AA10.9.NoOneGene_filter3	3MCC	14	7	1	22
test_AA10.9.NoOneGene_filter3	ARG	3	0	0	3
test_AA10.9.NoOneGene_filter3	BKT	2	0	0	2
test_AA10.9.NoOneGene_filter3	CIT	20	2	0	22
test_AA10.9.NoOneGene_filter3	CPT I	1	0	0	1
test_AA10.9.NoOneGene_filter3	CPT II	3	3	0	6
test_AA10.9.NoOneGene_filter3	CTD	21	7	1	29
test_AA10.9.NoOneGene_filter3	GA-I	23	4	0	27
test_AA10.9.NoOneGene_filter3	GA2	6	1	0	7
test_AA10.9.NoOneGene_filter3	HCY	6	1	1	8
test_AA10.9.NoOneGene_filter3	HYPRO	0	2	0	2
test_AA10.9.NoOneGene_filter3	IVA	22	4	1	27
test_AA10.9.NoOneGene_filter3	LCHAD	7	0	0	7
test_AA10.9.NoOneGene_filter3	MAL	2	4	0	6
test_AA10.9.NoOneGene_filter3	MCAD	117	10	1	128
test_AA10.9.NoOneGene_filter3	MCD	1	2	0	3
test_AA10.9.NoOneGene_filter3	MSUD	17	1	0	18
test_AA10.9.NoOneGene_filter3	OTC	6	0	0	6
test_AA10.9.NoOneGene_filter3	PA/MMA	51	12	1	64
test_AA10.9.NoOneGene_filter3	PKU	51	5	0	56
test_AA10.9.NoOneGene_filter3	SCAD	25	25	2	52
test_AA10.9.NoOneGene_filter3	TFP	3	0	0	3
test_AA10.9.NoOneGene_filter3	TYRO1	6	0	0	6
test_AA10.9.NoOneGene_filter3	VLCAD	29	6	0	35
test_AA10.5_batch2	3MCC	2	11	0	13
test_AA10.5_batch2	ARG	1	1	0	2
test_AA10.5_batch2	CIT	5	4	0	9
test_AA10.5_batch2	CPT I	1	0	0	1
test_AA10.5_batch2	CPT II	0	1	0	1
test_AA10.5_batch2	CTD	5	3	0	8
test_AA10.5_batch2	GA-I	6	2	0	8
test_AA10.5_batch2	GA2	0	2	0	2
test_AA10.5_batch2	HCY	0	1	0	1
test_AA10.5_batch2	IVA	7	5	1	13
test_AA10.5_batch2	LCHAD	1	1	0	2
test_AA10.5_batch2	MAL	0	1	0	1
test_AA10.5_batch2	MCAD	23	17	0	40
test_AA10.5_batch2	MSUD	2	1	0	3
test_AA10.5_batch2	OTC	3	4	0	7
test_AA10.5_batch2	PA/MMA	11	3	0	14
test_AA10.5_batch2	PKU	58	3	0	61
test_AA10.5_batch2	RMD	3	0	0	3
test_AA10.5_batch2	SCAD	4	26	1	31
test_AA10.5_batch2	TFP	0	1	0	1
test_AA10.5_batch2	TYRO1	1	0	0	1
test_AA10.5_batch2	VLCAD	1	4	0	5
AA10.1_filter3	3MCC	25	7	1	33
AA10.1_filter3	ARG	3	0	0	3
AA10.1_filter3	BKT	2	0	0	2
AA10.1_filter3	CIT	23	4	0	27
AA10.1_filter3	CPT I	1	0	0	1
AA10.1_filter3	CPT II	3	3	0	6
AA10.1_filter3	CTD	29	7	2	38
AA10.1_filter3	GA-I	24	4	0	28
AA10.1_filter3	GA2	8	1	0	9
AA10.1_filter3	HCY	7	1	1	9
AA10.1_filter3	HYPRO	0	2	0	2
AA10.1_filter3	IVA	24	4	1	29
AA10.1_filter3	LCHAD	7	0	0	7
AA10.1_filter3	MAL	2	4	0	6
AA10.1_filter3	MCAD	128	11	1	140
AA10.1_filter3	MCD	2	2	0	4
AA10.1_filter3	MSUD	17	3	0	20
AA10.1_filter3	OTC	9	0	0	9
AA10.1_filter3	PA/MMA	60	12	1	73
AA10.1_filter3	PKU	83	5	0	88
AA10.1_filter3	SCAD	33	32	2	67
AA10.1_filter3	TFP	4	0	0	4
AA10.1_filter3	TYRO1	6	0	0	6
AA10.1_filter3	VLCAD	33	6	0	39
test_AA10.1_filter4	3MCC	9	4	0	13
test_AA10.1_filter4	ARG	1	0	0	1
test_AA10.1_filter4	BKT	2	0	0	2
test_AA10.1_filter4	CIT	13	1	0	14
test_AA10.1_filter4	CPT II	3	3	0	6
test_AA10.1_filter4	CTD	16	6	2	24
test_AA10.1_filter4	GA-I	20	3	0	23
test_AA10.1_filter4	GA2	5	0	0	5
test_AA10.1_filter4	HCY	5	1	1	7
test_AA10.1_filter4	HYPRO	0	1	0	1
test_AA10.1_filter4	IVA	15	4	1	20
test_AA10.1_filter4	LCHAD	6	0	0	6
test_AA10.1_filter4	MAL	2	1	0	3
test_AA10.1_filter4	MCAD	87	9	1	97
test_AA10.1_filter4	MCD	1	2	0	3
test_AA10.1_filter4	MSUD	9	1	0	10
test_AA10.1_filter4	OTC	5	0	0	5
test_AA10.1_filter4	PA/MMA	40	11	1	52
test_AA10.1_filter4	PKU	21	4	0	25
test_AA10.1_filter4	SCAD	21	9	1	31
test_AA10.1_filter4	TFP	3	0	0	3
test_AA10.1_filter4	TYRO1	6	0	0	6
test_AA10.1_filter4	VLCAD	21	6	0	27
AA10.6_batch2	3MCC	6	6	1	13
AA10.6_batch2	ARG	2	0	0	2
AA10.6_batch2	CIT	7	2	0	9
AA10.6_batch2	CPT I	1	0	0	1
AA10.6_batch2	CPT II	0	1	0	1
AA10.6_batch2	CTD	7	1	0	8
AA10.6_batch2	GA-I	8	0	0	8
AA10.6_batch2	GA2	1	1	0	2
AA10.6_batch2	HCY	1	0	0	1
AA10.6_batch2	IVA	13	0	0	13
AA10.6_batch2	LCHAD	2	0	0	2
AA10.6_batch2	MAL	0	1	0	1
AA10.6_batch2	MCAD	39	1	0	40
AA10.6_batch2	MSUD	3	0	0	3
AA10.6_batch2	OTC	5	2	0	7
AA10.6_batch2	PA/MMA	13	1	0	14
AA10.6_batch2	PKU	59	2	0	61
AA10.6_batch2	RMD	3	0	0	3
AA10.6_batch2	SCAD	10	21	0	31
AA10.6_batch2	TFP	1	0	0	1
AA10.6_batch2	TYRO1	1	0	0	1
AA10.6_batch2	VLCAD	5	0	0	5
AA10.8_batch1	3MCC	3	12	0	15
AA10.8_batch1	BKT	0	1	0	1
AA10.8_batch1	CIT	4	3	0	7
AA10.8_batch1	CTD	5	4	0	9
AA10.8_batch1	GA-I	0	1	0	1
AA10.8_batch1	GA2	2	2	0	4
AA10.8_batch1	HCY	0	1	0	1
AA10.8_batch1	IVA	1	2	0	3
AA10.8_batch1	MCAD	5	12	0	17
AA10.8_batch1	MCD	0	1	0	1
AA10.8_batch1	MSUD	1	2	0	3
AA10.8_batch1	OTC	1	4	0	5
AA10.8_batch1	PA/MMA	5	4	0	9
AA10.8_batch1	PKU	36	3	0	39
AA10.8_batch1	SCAD	2	15	0	17
AA10.8_batch1	TFP	0	1	0	1
AA10.8_batch1	VLCAD	3	2	0	5
test_AA10.9.NoOneGene_batch2	3MCC	6	6	1	13
test_AA10.9.NoOneGene_batch2	ARG	2	0	0	2
test_AA10.9.NoOneGene_batch2	CIT	7	2	0	9
test_AA10.9.NoOneGene_batch2	CPT I	1	0	0	1
test_AA10.9.NoOneGene_batch2	CPT II	0	1	0	1
test_AA10.9.NoOneGene_batch2	CTD	7	1	0	8
test_AA10.9.NoOneGene_batch2	GA-I	8	0	0	8
test_AA10.9.NoOneGene_batch2	GA2	1	1	0	2
test_AA10.9.NoOneGene_batch2	HCY	1	0	0	1
test_AA10.9.NoOneGene_batch2	IVA	13	0	0	13
test_AA10.9.NoOneGene_batch2	LCHAD	2	0	0	2
test_AA10.9.NoOneGene_batch2	MAL	0	1	0	1
test_AA10.9.NoOneGene_batch2	MCAD	40	0	0	40
test_AA10.9.NoOneGene_batch2	MSUD	3	0	0	3
test_AA10.9.NoOneGene_batch2	OTC	5	2	0	7
test_AA10.9.NoOneGene_batch2	PA/MMA	13	1	0	14
test_AA10.9.NoOneGene_batch2	PKU	59	2	0	61
test_AA10.9.NoOneGene_batch2	RMD	3	0	0	3
test_AA10.9.NoOneGene_batch2	SCAD	9	21	1	31
test_AA10.9.NoOneGene_batch2	TFP	1	0	0	1
test_AA10.9.NoOneGene_batch2	TYRO1	1	0	0	1
test_AA10.9.NoOneGene_batch2	VLCAD	5	0	0	5
AA10.9.NoOneGene_batch3	3MCC	13	4	0	17
AA10.9.NoOneGene_batch3	ARG	2	0	0	2
AA10.9.NoOneGene_batch3	BKT	2	0	0	2
AA10.9.NoOneGene_batch3	CIT	16	1	0	17
AA10.9.NoOneGene_batch3	CPT II	5	2	0	7
AA10.9.NoOneGene_batch3	CTD	21	8	1	30
AA10.9.NoOneGene_batch3	GA-I	22	4	1	27
AA10.9.NoOneGene_batch3	GA2	5	1	0	6
AA10.9.NoOneGene_batch3	HCY	7	2	1	10
AA10.9.NoOneGene_batch3	HYPRO	0	3	0	3
AA10.9.NoOneGene_batch3	IVA	18	5	1	24
AA10.9.NoOneGene_batch3	LCHAD	7	0	0	7
AA10.9.NoOneGene_batch3	MAL	2	3	0	5
AA10.9.NoOneGene_batch3	MCAD	106	10	1	117
AA10.9.NoOneGene_batch3	MCD	1	3	0	4
AA10.9.NoOneGene_batch3	MSUD	17	2	0	19
AA10.9.NoOneGene_batch3	OTC	4	0	0	4
AA10.9.NoOneGene_batch3	PA/MMA	52	14	1	67
AA10.9.NoOneGene_batch3	PKU	25	6	0	31
AA10.9.NoOneGene_batch3	SCAD	22	12	2	36
AA10.9.NoOneGene_batch3	TFP	2	0	0	2
AA10.9.NoOneGene_batch3	TYRO1	6	0	0	6
AA10.9.NoOneGene_batch3	VLCAD	31	6	0	37
AA10.6.NonSyn.005_batch3	3MCC	7	10	0	17
AA10.6.NonSyn.005_batch3	ARG	1	1	0	2
AA10.6.NonSyn.005_batch3	BKT	0	2	0	2
AA10.6.NonSyn.005_batch3	CIT	10	7	0	17
AA10.6.NonSyn.005_batch3	CPT II	1	6	0	7
AA10.6.NonSyn.005_batch3	CTD	12	16	2	30
AA10.6.NonSyn.005_batch3	GA-I	18	9	0	27
AA10.6.NonSyn.005_batch3	GA2	4	2	0	6
AA10.6.NonSyn.005_batch3	HCY	4	4	2	10
AA10.6.NonSyn.005_batch3	HYPRO	0	3	0	3
AA10.6.NonSyn.005_batch3	IVA	12	11	1	24
AA10.6.NonSyn.005_batch3	LCHAD	2	5	0	7
AA10.6.NonSyn.005_batch3	MAL	1	4	0	5
AA10.6.NonSyn.005_batch3	MCAD	86	30	1	117
AA10.6.NonSyn.005_batch3	MCD	1	3	0	4
AA10.6.NonSyn.005_batch3	MSUD	10	8	1	19
AA10.6.NonSyn.005_batch3	OTC	4	0	0	4
AA10.6.NonSyn.005_batch3	PA/MMA	15	50	2	67
AA10.6.NonSyn.005_batch3	PKU	16	15	0	31
AA10.6.NonSyn.005_batch3	SCAD	16	19	1	36
AA10.6.NonSyn.005_batch3	TFP	1	1	0	2
AA10.6.NonSyn.005_batch3	TYRO1	2	4	0	6
AA10.6.NonSyn.005_batch3	VLCAD	21	16	0	37
val_AA10.6	3MCC	14	1	0	15
val_AA10.6	BKT	1	0	0	1
val_AA10.6	CIT	5	2	0	7
val_AA10.6	CTD	9	0	0	9
val_AA10.6	GA-I	1	0	0	1
val_AA10.6	GA2	3	1	0	4
val_AA10.6	HCY	0	1	0	1
val_AA10.6	IVA	1	2	0	3
val_AA10.6	MCAD	16	1	0	17
val_AA10.6	MCD	1	0	0	1
val_AA10.6	MSUD	1	1	1	3
val_AA10.6	OTC	3	2	0	5
val_AA10.6	PA/MMA	7	2	0	9
val_AA10.6	PKU	37	2	0	39
val_AA10.6	SCAD	9	8	0	17
val_AA10.6	TFP	1	0	0	1
val_AA10.6	VLCAD	4	1	0	5
test_AA10.2_filter2	3MCC	16	9	1	26
test_AA10.2_filter2	ARG	3	0	0	3
test_AA10.2_filter2	BKT	2	0	0	2
test_AA10.2_filter2	CIT	20	2	0	22
test_AA10.2_filter2	CPT I	1	0	0	1
test_AA10.2_filter2	CPT II	5	3	0	8
test_AA10.2_filter2	CTD	24	7	2	33
test_AA10.2_filter2	GA-I	26	4	0	30
test_AA10.2_filter2	GA2	6	1	0	7
test_AA10.2_filter2	HCY	7	1	1	9
test_AA10.2_filter2	HYPRO	0	2	0	2
test_AA10.2_filter2	IVA	25	5	1	31
test_AA10.2_filter2	LCHAD	9	0	0	9
test_AA10.2_filter2	MAL	2	4	0	6
test_AA10.2_filter2	MCAD	127	10	1	138
test_AA10.2_filter2	MCD	1	2	0	3
test_AA10.2_filter2	MSUD	20	2	0	22
test_AA10.2_filter2	OTC	8	1	0	9
test_AA10.2_filter2	PA/MMA	56	13	1	70
test_AA10.2_filter2	PKU	71	5	0	76
test_AA10.2_filter2	RMD	1	0	0	1
test_AA10.2_filter2	SCAD	28	29	3	60
test_AA10.2_filter2	TFP	3	0	0	3
test_AA10.2_filter2	TYRO1	6	0	0	6
test_AA10.2_filter2	VLCAD	30	6	0	36
val_AA10.9.NoOneGene_batch1	3MCC	14	1	0	15
val_AA10.9.NoOneGene_batch1	BKT	1	0	0	1
val_AA10.9.NoOneGene_batch1	CIT	5	2	0	7
val_AA10.9.NoOneGene_batch1	CTD	9	0	0	9
val_AA10.9.NoOneGene_batch1	GA-I	1	0	0	1
val_AA10.9.NoOneGene_batch1	GA2	3	1	0	4
val_AA10.9.NoOneGene_batch1	HCY	1	0	0	1
val_AA10.9.NoOneGene_batch1	IVA	3	0	0	3
val_AA10.9.NoOneGene_batch1	MCAD	16	1	0	17
val_AA10.9.NoOneGene_batch1	MCD	1	0	0	1
val_AA10.9.NoOneGene_batch1	MSUD	2	1	0	3
val_AA10.9.NoOneGene_batch1	OTC	4	1	0	5
val_AA10.9.NoOneGene_batch1	PA/MMA	9	0	0	9
val_AA10.9.NoOneGene_batch1	PKU	39	0	0	39
val_AA10.9.NoOneGene_batch1	SCAD	9	8	0	17
val_AA10.9.NoOneGene_batch1	TFP	1	0	0	1
val_AA10.9.NoOneGene_batch1	VLCAD	5	0	0	5
test_AA10.6.NonSyn.02_filter4	3MCC	3	10	0	13
test_AA10.6.NonSyn.02_filter4	ARG	1	0	0	1
test_AA10.6.NonSyn.02_filter4	BKT	0	2	0	2
test_AA10.6.NonSyn.02_filter4	CIT	9	5	0	14
test_AA10.6.NonSyn.02_filter4	CPT II	1	4	1	6
test_AA10.6.NonSyn.02_filter4	CTD	9	12	3	24
test_AA10.6.NonSyn.02_filter4	GA-I	14	9	0	23
test_AA10.6.NonSyn.02_filter4	GA2	3	2	0	5
test_AA10.6.NonSyn.02_filter4	HCY	3	3	1	7
test_AA10.6.NonSyn.02_filter4	HYPRO	0	1	0	1
test_AA10.6.NonSyn.02_filter4	IVA	8	11	1	20
test_AA10.6.NonSyn.02_filter4	LCHAD	2	3	1	6
test_AA10.6.NonSyn.02_filter4	MAL	1	2	0	3
test_AA10.6.NonSyn.02_filter4	MCAD	71	23	3	97
test_AA10.6.NonSyn.02_filter4	MCD	1	2	0	3
test_AA10.6.NonSyn.02_filter4	MSUD	6	4	0	10
test_AA10.6.NonSyn.02_filter4	OTC	4	1	0	5
test_AA10.6.NonSyn.02_filter4	PA/MMA	12	37	3	52
test_AA10.6.NonSyn.02_filter4	PKU	14	11	0	25
test_AA10.6.NonSyn.02_filter4	SCAD	18	11	2	31
test_AA10.6.NonSyn.02_filter4	TFP	1	2	0	3
test_AA10.6.NonSyn.02_filter4	TYRO1	3	3	0	6
test_AA10.6.NonSyn.02_filter4	VLCAD	14	13	0	27
AA10.7_filter2	3MCC	9	32	0	41
AA10.7_filter2	ARG	1	2	0	3
AA10.7_filter2	BKT	0	3	0	3
AA10.7_filter2	CIT	14	14	0	28
AA10.7_filter2	CPT I	1	0	0	1
AA10.7_filter2	CPT II	3	5	0	8
AA10.7_filter2	CTD	22	18	2	42
AA10.7_filter2	GA-I	16	15	0	31
AA10.7_filter2	GA2	5	6	0	11
AA10.7_filter2	HCY	5	4	1	10
AA10.7_filter2	HYPRO	0	2	0	2
AA10.7_filter2	IVA	13	19	2	34
AA10.7_filter2	LCHAD	5	4	0	9
AA10.7_filter2	MAL	1	5	0	6
AA10.7_filter2	MCAD	80	73	2	155
AA10.7_filter2	MCD	1	3	0	4
AA10.7_filter2	MSUD	9	16	0	25
AA10.7_filter2	OTC	8	6	0	14
AA10.7_filter2	PA/MMA	52	27	0	79
AA10.7_filter2	PKU	107	8	0	115
AA10.7_filter2	RMD	1	0	0	1
AA10.7_filter2	SCAD	20	55	2	77
AA10.7_filter2	TFP	1	3	0	4
AA10.7_filter2	TYRO1	5	1	0	6
AA10.7_filter2	VLCAD	21	20	0	41
AA10.9.NoOneGene_filter1	3MCC	31	10	1	42
AA10.9.NoOneGene_filter1	ARG	3	0	0	3
AA10.9.NoOneGene_filter1	BKT	3	0	0	3
AA10.9.NoOneGene_filter1	CIT	25	4	0	29
AA10.9.NoOneGene_filter1	CPT I	1	0	0	1
AA10.9.NoOneGene_filter1	CPT II	5	3	0	8
AA10.9.NoOneGene_filter1	CTD	35	7	1	43
AA10.9.NoOneGene_filter1	GA-I	28	4	0	32
AA10.9.NoOneGene_filter1	GA2	9	2	0	11
AA10.9.NoOneGene_filter1	HCY	9	1	1	11
AA10.9.NoOneGene_filter1	HYPRO	0	2	0	2
AA10.9.NoOneGene_filter1	IVA	30	5	1	36
AA10.9.NoOneGene_filter1	LCHAD	9	0	0	9
AA10.9.NoOneGene_filter1	MAL	2	4	0	6
AA10.9.NoOneGene_filter1	MCAD	148	11	1	160
AA10.9.NoOneGene_filter1	MCD	2	2	0	4
AA10.9.NoOneGene_filter1	MSUD	22	3	0	25
AA10.9.NoOneGene_filter1	OTC	12	2	0	14
AA10.9.NoOneGene_filter1	PA/MMA	68	13	1	82
AA10.9.NoOneGene_filter1	PKU	112	6	0	118
AA10.9.NoOneGene_filter1	RMD	1	0	0	1
AA10.9.NoOneGene_filter1	SCAD	40	37	3	80
AA10.9.NoOneGene_filter1	TFP	4	0	0	4
AA10.9.NoOneGene_filter1	TYRO1	7	0	0	7
AA10.9.NoOneGene_filter1	VLCAD	38	6	0	44
AA10.6.NonSyn.01_batch3	3MCC	7	10	0	17
AA10.6.NonSyn.01_batch3	ARG	1	1	0	2
AA10.6.NonSyn.01_batch3	BKT	0	2	0	2
AA10.6.NonSyn.01_batch3	CIT	10	7	0	17
AA10.6.NonSyn.01_batch3	CPT II	1	6	0	7
AA10.6.NonSyn.01_batch3	CTD	12	15	3	30
AA10.6.NonSyn.01_batch3	GA-I	18	9	0	27
AA10.6.NonSyn.01_batch3	GA2	4	2	0	6
AA10.6.NonSyn.01_batch3	HCY	4	4	2	10
AA10.6.NonSyn.01_batch3	HYPRO	0	3	0	3
AA10.6.NonSyn.01_batch3	IVA	12	11	1	24
AA10.6.NonSyn.01_batch3	LCHAD	2	5	0	7
AA10.6.NonSyn.01_batch3	MAL	1	4	0	5
AA10.6.NonSyn.01_batch3	MCAD	86	30	1	117
AA10.6.NonSyn.01_batch3	MCD	1	3	0	4
AA10.6.NonSyn.01_batch3	MSUD	10	8	1	19
AA10.6.NonSyn.01_batch3	OTC	4	0	0	4
AA10.6.NonSyn.01_batch3	PA/MMA	16	48	3	67
AA10.6.NonSyn.01_batch3	PKU	16	15	0	31
AA10.6.NonSyn.01_batch3	SCAD	16	18	2	36
AA10.6.NonSyn.01_batch3	TFP	1	1	0	2
AA10.6.NonSyn.01_batch3	TYRO1	2	4	0	6
AA10.6.NonSyn.01_batch3	VLCAD	21	16	0	37
val_AA10.6.NonSyn.01_filter1	3MCC	8	7	0	15
val_AA10.6.NonSyn.01_filter1	BKT	1	0	0	1
val_AA10.6.NonSyn.01_filter1	CIT	2	3	1	6
val_AA10.6.NonSyn.01_filter1	CTD	4	4	1	9
val_AA10.6.NonSyn.01_filter1	GA-I	1	0	0	1
val_AA10.6.NonSyn.01_filter1	GA2	3	1	0	4
val_AA10.6.NonSyn.01_filter1	HCY	0	1	0	1
val_AA10.6.NonSyn.01_filter1	IVA	1	2	0	3
val_AA10.6.NonSyn.01_filter1	MCAD	14	3	0	17
val_AA10.6.NonSyn.01_filter1	MCD	0	1	0	1
val_AA10.6.NonSyn.01_filter1	MSUD	1	1	1	3
val_AA10.6.NonSyn.01_filter1	OTC	3	2	0	5
val_AA10.6.NonSyn.01_filter1	PA/MMA	4	5	0	9
val_AA10.6.NonSyn.01_filter1	PKU	22	17	0	39
val_AA10.6.NonSyn.01_filter1	SCAD	8	9	0	17
val_AA10.6.NonSyn.01_filter1	TFP	0	1	0	1
val_AA10.6.NonSyn.01_filter1	VLCAD	2	3	0	5
AA10.9.NoOneGene	3MCC	33	11	1	45
AA10.9.NoOneGene	ARG	4	0	0	4
AA10.9.NoOneGene	BKT	3	0	0	3
AA10.9.NoOneGene	CIT	28	5	0	33
AA10.9.NoOneGene	CPT I	1	0	0	1
AA10.9.NoOneGene	CPT II	5	3	0	8
AA10.9.NoOneGene	CTD	37	9	1	47
AA10.9.NoOneGene	GA-I	31	4	1	36
AA10.9.NoOneGene	GA2	9	3	0	12
AA10.9.NoOneGene	HCY	9	2	1	12
AA10.9.NoOneGene	HYPRO	0	3	0	3
AA10.9.NoOneGene	IVA	34	5	1	40
AA10.9.NoOneGene	LCHAD	9	0	0	9
AA10.9.NoOneGene	MAL	2	4	0	6
AA10.9.NoOneGene	MCAD	162	11	1	174
AA10.9.NoOneGene	MCD	2	3	0	5
AA10.9.NoOneGene	MSUD	22	3	0	25
AA10.9.NoOneGene	OTC	13	3	0	16
AA10.9.NoOneGene	PA/MMA	74	15	1	90
AA10.9.NoOneGene	PKU	123	8	0	131
AA10.9.NoOneGene	RMD	3	0	0	3
AA10.9.NoOneGene	SCAD	40	41	3	84
AA10.9.NoOneGene	TFP	4	0	0	4
AA10.9.NoOneGene	TYRO1	7	0	0	7
AA10.9.NoOneGene	VLCAD	41	6	0	47
AA10.9.NoOneGene_filter4	3MCC	20	4	0	24
AA10.9.NoOneGene_filter4	ARG	1	0	0	1
AA10.9.NoOneGene_filter4	BKT	2	0	0	2
AA10.9.NoOneGene_filter4	CIT	16	3	0	19
AA10.9.NoOneGene_filter4	CPT II	3	3	0	6
AA10.9.NoOneGene_filter4	CTD	26	6	1	33
AA10.9.NoOneGene_filter4	GA-I	21	3	0	24
AA10.9.NoOneGene_filter4	GA2	7	0	0	7
AA10.9.NoOneGene_filter4	HCY	6	1	1	8
AA10.9.NoOneGene_filter4	HYPRO	0	1	0	1
AA10.9.NoOneGene_filter4	IVA	17	4	1	22
AA10.9.NoOneGene_filter4	LCHAD	6	0	0	6
AA10.9.NoOneGene_filter4	MAL	2	1	0	3
AA10.9.NoOneGene_filter4	MCAD	98	10	1	109
AA10.9.NoOneGene_filter4	MCD	2	2	0	4
AA10.9.NoOneGene_filter4	MSUD	10	2	0	12
AA10.9.NoOneGene_filter4	OTC	8	0	0	8
AA10.9.NoOneGene_filter4	PA/MMA	49	11	1	61
AA10.9.NoOneGene_filter4	PKU	53	4	0	57
AA10.9.NoOneGene_filter4	SCAD	29	16	1	46
AA10.9.NoOneGene_filter4	TFP	4	0	0	4
AA10.9.NoOneGene_filter4	TYRO1	6	0	0	6
AA10.9.NoOneGene_filter4	VLCAD	25	6	0	31
test_AA10.6.NonSyn.005_filter1	3MCC	11	15	1	27
test_AA10.6.NonSyn.005_filter1	ARG	1	1	1	3
test_AA10.6.NonSyn.005_filter1	BKT	0	2	0	2
test_AA10.6.NonSyn.005_filter1	CIT	16	7	0	23
test_AA10.6.NonSyn.005_filter1	CPT I	0	1	0	1
test_AA10.6.NonSyn.005_filter1	CPT II	1	7	0	8
test_AA10.6.NonSyn.005_filter1	CTD	16	16	2	34
test_AA10.6.NonSyn.005_filter1	GA-I	20	11	0	31
test_AA10.6.NonSyn.005_filter1	GA2	4	3	0	7
test_AA10.6.NonSyn.005_filter1	HCY	5	3	2	10
test_AA10.6.NonSyn.005_filter1	HYPRO	0	2	0	2
test_AA10.6.NonSyn.005_filter1	IVA	18	13	2	33
test_AA10.6.NonSyn.005_filter1	LCHAD	2	7	0	9
test_AA10.6.NonSyn.005_filter1	MAL	1	5	0	6
test_AA10.6.NonSyn.005_filter1	MCAD	106	36	1	143
test_AA10.6.NonSyn.005_filter1	MCD	1	2	0	3
test_AA10.6.NonSyn.005_filter1	MSUD	12	9	1	22
test_AA10.6.NonSyn.005_filter1	OTC	6	3	0	9
test_AA10.6.NonSyn.005_filter1	PA/MMA	17	54	2	73
test_AA10.6.NonSyn.005_filter1	PKU	38	40	1	79
test_AA10.6.NonSyn.005_filter1	RMD	1	0	0	1
test_AA10.6.NonSyn.005_filter1	SCAD	23	39	1	63
test_AA10.6.NonSyn.005_filter1	TFP	1	2	0	3
test_AA10.6.NonSyn.005_filter1	TYRO1	3	4	0	7
test_AA10.6.NonSyn.005_filter1	VLCAD	21	18	0	39
val_AA10.4	3MCC	14	1	0	15
val_AA10.4	BKT	1	0	0	1
val_AA10.4	CIT	5	2	0	7
val_AA10.4	CTD	9	0	0	9
val_AA10.4	GA-I	1	0	0	1
val_AA10.4	GA2	3	1	0	4
val_AA10.4	HCY	0	1	0	1
val_AA10.4	IVA	3	0	0	3
val_AA10.4	MCAD	16	1	0	17
val_AA10.4	MCD	1	0	0	1
val_AA10.4	MSUD	1	1	1	3
val_AA10.4	OTC	4	1	0	5
val_AA10.4	PA/MMA	8	1	0	9
val_AA10.4	PKU	37	2	0	39
val_AA10.4	SCAD	9	8	0	17
val_AA10.4	TFP	1	0	0	1
val_AA10.4	VLCAD	4	1	0	5
test_AA10.8_filter3	3MCC	5	17	0	22
test_AA10.8_filter3	ARG	1	2	0	3
test_AA10.8_filter3	BKT	0	2	0	2
test_AA10.8_filter3	CIT	11	11	0	22
test_AA10.8_filter3	CPT I	1	0	0	1
test_AA10.8_filter3	CPT II	2	4	0	6
test_AA10.8_filter3	CTD	13	15	1	29
test_AA10.8_filter3	GA-I	13	14	0	27
test_AA10.8_filter3	GA2	3	4	0	7
test_AA10.8_filter3	HCY	2	5	1	8
test_AA10.8_filter3	HYPRO	0	2	0	2
test_AA10.8_filter3	IVA	12	14	1	27
test_AA10.8_filter3	LCHAD	4	3	0	7
test_AA10.8_filter3	MAL	1	5	0	6
test_AA10.8_filter3	MCAD	67	61	0	128
test_AA10.8_filter3	MCD	1	2	0	3
test_AA10.8_filter3	MSUD	5	13	0	18
test_AA10.8_filter3	OTC	6	0	0	6
test_AA10.8_filter3	PA/MMA	40	24	0	64
test_AA10.8_filter3	PKU	48	8	0	56
test_AA10.8_filter3	SCAD	2	50	0	52
test_AA10.8_filter3	TFP	1	2	0	3
test_AA10.8_filter3	TYRO1	5	1	0	6
test_AA10.8_filter3	VLCAD	17	18	0	35
test_AA10.7	3MCC	8	22	0	30
test_AA10.7	ARG	2	2	0	4
test_AA10.7	BKT	0	2	0	2
test_AA10.7	CIT	14	12	0	26
test_AA10.7	CPT I	1	0	0	1
test_AA10.7	CPT II	3	5	0	8
test_AA10.7	CTD	17	19	2	38
test_AA10.7	GA-I	20	14	1	35
test_AA10.7	GA2	3	5	0	8
test_AA10.7	HCY	4	6	1	11
test_AA10.7	HYPRO	0	3	0	3
test_AA10.7	IVA	17	18	2	37
test_AA10.7	LCHAD	5	4	0	9
test_AA10.7	MAL	1	5	0	6
test_AA10.7	MCAD	86	69	2	157
test_AA10.7	MCD	1	3	0	4
test_AA10.7	MSUD	8	14	0	22
test_AA10.7	OTC	7	4	0	11
test_AA10.7	PA/MMA	53	28	0	81
test_AA10.7	PKU	83	9	0	92
test_AA10.7	RMD	3	0	0	3
test_AA10.7	SCAD	15	50	2	67
test_AA10.7	TFP	1	2	0	3
test_AA10.7	TYRO1	6	1	0	7
test_AA10.7	VLCAD	20	22	0	42
AA10.6.NonSyn.01_filter1	3MCC	19	22	1	42
AA10.6.NonSyn.01_filter1	ARG	1	1	1	3
AA10.6.NonSyn.01_filter1	BKT	1	2	0	3
AA10.6.NonSyn.01_filter1	CIT	18	10	1	29
AA10.6.NonSyn.01_filter1	CPT I	0	1	0	1
AA10.6.NonSyn.01_filter1	CPT II	1	7	0	8
AA10.6.NonSyn.01_filter1	CTD	20	19	4	43
AA10.6.NonSyn.01_filter1	GA-I	21	11	0	32
AA10.6.NonSyn.01_filter1	GA2	7	4	0	11
AA10.6.NonSyn.01_filter1	HCY	5	4	2	11
AA10.6.NonSyn.01_filter1	HYPRO	0	2	0	2
AA10.6.NonSyn.01_filter1	IVA	19	15	2	36
AA10.6.NonSyn.01_filter1	LCHAD	2	6	1	9
AA10.6.NonSyn.01_filter1	MAL	1	5	0	6
AA10.6.NonSyn.01_filter1	MCAD	120	39	1	160
AA10.6.NonSyn.01_filter1	MCD	1	3	0	4
AA10.6.NonSyn.01_filter1	MSUD	13	10	2	25
AA10.6.NonSyn.01_filter1	OTC	9	5	0	14
AA10.6.NonSyn.01_filter1	PA/MMA	22	57	3	82
AA10.6.NonSyn.01_filter1	PKU	60	57	1	118
AA10.6.NonSyn.01_filter1	RMD	1	0	0	1
AA10.6.NonSyn.01_filter1	SCAD	31	46	3	80
AA10.6.NonSyn.01_filter1	TFP	1	3	0	4
AA10.6.NonSyn.01_filter1	TYRO1	3	4	0	7
AA10.6.NonSyn.01_filter1	VLCAD	23	21	0	44
test_AA10.7_batch2	3MCC	2	11	0	13
test_AA10.7_batch2	ARG	1	1	0	2
test_AA10.7_batch2	CIT	5	4	0	9
test_AA10.7_batch2	CPT I	1	0	0	1
test_AA10.7_batch2	CPT II	0	1	0	1
test_AA10.7_batch2	CTD	5	3	0	8
test_AA10.7_batch2	GA-I	6	2	0	8
test_AA10.7_batch2	GA2	0	2	0	2
test_AA10.7_batch2	HCY	0	1	0	1
test_AA10.7_batch2	IVA	7	5	1	13
test_AA10.7_batch2	LCHAD	1	1	0	2
test_AA10.7_batch2	MAL	0	1	0	1
test_AA10.7_batch2	MCAD	23	17	0	40
test_AA10.7_batch2	MSUD	2	1	0	3
test_AA10.7_batch2	OTC	3	4	0	7
test_AA10.7_batch2	PA/MMA	11	3	0	14
test_AA10.7_batch2	PKU	58	3	0	61
test_AA10.7_batch2	RMD	3	0	0	3
test_AA10.7_batch2	SCAD	4	26	1	31
test_AA10.7_batch2	TFP	0	1	0	1
test_AA10.7_batch2	TYRO1	1	0	0	1
test_AA10.7_batch2	VLCAD	1	4	0	5
AA10.6.NonSyn.01_filter2	3MCC	18	22	1	41
AA10.6.NonSyn.01_filter2	ARG	1	1	1	3
AA10.6.NonSyn.01_filter2	BKT	1	2	0	3
AA10.6.NonSyn.01_filter2	CIT	17	10	1	28
AA10.6.NonSyn.01_filter2	CPT I	0	1	0	1
AA10.6.NonSyn.01_filter2	CPT II	1	7	0	8
AA10.6.NonSyn.01_filter2	CTD	19	19	4	42
AA10.6.NonSyn.01_filter2	GA-I	20	11	0	31
AA10.6.NonSyn.01_filter2	GA2	7	4	0	11
AA10.6.NonSyn.01_filter2	HCY	4	4	2	10
AA10.6.NonSyn.01_filter2	HYPRO	0	2	0	2
AA10.6.NonSyn.01_filter2	IVA	17	15	2	34
AA10.6.NonSyn.01_filter2	LCHAD	2	6	1	9
AA10.6.NonSyn.01_filter2	MAL	1	5	0	6
AA10.6.NonSyn.01_filter2	MCAD	117	37	1	155
AA10.6.NonSyn.01_filter2	MCD	1	3	0	4
AA10.6.NonSyn.01_filter2	MSUD	13	10	2	25
AA10.6.NonSyn.01_filter2	OTC	9	5	0	14
AA10.6.NonSyn.01_filter2	PA/MMA	22	54	3	79
AA10.6.NonSyn.01_filter2	PKU	58	56	1	115
AA10.6.NonSyn.01_filter2	RMD	1	0	0	1
AA10.6.NonSyn.01_filter2	SCAD	30	44	3	77
AA10.6.NonSyn.01_filter2	TFP	1	3	0	4
AA10.6.NonSyn.01_filter2	TYRO1	3	3	0	6
AA10.6.NonSyn.01_filter2	VLCAD	21	20	0	41
val_AA10.4_batch1	3MCC	14	1	0	15
val_AA10.4_batch1	BKT	1	0	0	1
val_AA10.4_batch1	CIT	5	2	0	7
val_AA10.4_batch1	CTD	9	0	0	9
val_AA10.4_batch1	GA-I	1	0	0	1
val_AA10.4_batch1	GA2	3	1	0	4
val_AA10.4_batch1	HCY	0	1	0	1
val_AA10.4_batch1	IVA	3	0	0	3
val_AA10.4_batch1	MCAD	16	1	0	17
val_AA10.4_batch1	MCD	1	0	0	1
val_AA10.4_batch1	MSUD	1	1	1	3
val_AA10.4_batch1	OTC	4	1	0	5
val_AA10.4_batch1	PA/MMA	8	1	0	9
val_AA10.4_batch1	PKU	37	2	0	39
val_AA10.4_batch1	SCAD	9	8	0	17
val_AA10.4_batch1	TFP	1	0	0	1
val_AA10.4_batch1	VLCAD	4	1	0	5
AA10.6.NonSyn.01_batch2	3MCC	6	6	1	13
AA10.6.NonSyn.01_batch2	ARG	0	1	1	2
AA10.6.NonSyn.01_batch2	CIT	6	2	1	9
AA10.6.NonSyn.01_batch2	CPT I	0	1	0	1
AA10.6.NonSyn.01_batch2	CPT II	0	1	0	1
AA10.6.NonSyn.01_batch2	CTD	6	2	0	8
AA10.6.NonSyn.01_batch2	GA-I	5	3	0	8
AA10.6.NonSyn.01_batch2	GA2	0	2	0	2
AA10.6.NonSyn.01_batch2	HCY	1	0	0	1
AA10.6.NonSyn.01_batch2	IVA	10	2	1	13
AA10.6.NonSyn.01_batch2	LCHAD	0	1	1	2
AA10.6.NonSyn.01_batch2	MAL	0	1	0	1
AA10.6.NonSyn.01_batch2	MCAD	32	8	0	40
AA10.6.NonSyn.01_batch2	MSUD	2	1	0	3
AA10.6.NonSyn.01_batch2	OTC	3	4	0	7
AA10.6.NonSyn.01_batch2	PA/MMA	4	9	1	14
AA10.6.NonSyn.01_batch2	PKU	27	33	1	61
AA10.6.NonSyn.01_batch2	RMD	1	2	0	3
AA10.6.NonSyn.01_batch2	SCAD	7	23	1	31
AA10.6.NonSyn.01_batch2	TFP	0	1	0	1
AA10.6.NonSyn.01_batch2	TYRO1	1	0	0	1
AA10.6.NonSyn.01_batch2	VLCAD	2	3	0	5
test_AA10.6.NonSyn.01	3MCC	13	16	1	30
test_AA10.6.NonSyn.01	ARG	1	2	1	4
test_AA10.6.NonSyn.01	BKT	0	2	0	2
test_AA10.6.NonSyn.01	CIT	16	9	1	26
test_AA10.6.NonSyn.01	CPT I	0	1	0	1
test_AA10.6.NonSyn.01	CPT II	1	7	0	8
test_AA10.6.NonSyn.01	CTD	18	17	3	38
test_AA10.6.NonSyn.01	GA-I	23	12	0	35
test_AA10.6.NonSyn.01	GA2	4	4	0	8
test_AA10.6.NonSyn.01	HCY	5	4	2	11
test_AA10.6.NonSyn.01	HYPRO	0	3	0	3
test_AA10.6.NonSyn.01	IVA	22	13	2	37
test_AA10.6.NonSyn.01	LCHAD	2	6	1	9
test_AA10.6.NonSyn.01	MAL	1	5	0	6
test_AA10.6.NonSyn.01	MCAD	118	38	1	157
test_AA10.6.NonSyn.01	MCD	1	3	0	4
test_AA10.6.NonSyn.01	MSUD	12	9	1	22
test_AA10.6.NonSyn.01	OTC	7	4	0	11
test_AA10.6.NonSyn.01	PA/MMA	20	57	4	81
test_AA10.6.NonSyn.01	PKU	43	48	1	92
test_AA10.6.NonSyn.01	RMD	1	2	0	3
test_AA10.6.NonSyn.01	SCAD	23	41	3	67
test_AA10.6.NonSyn.01	TFP	1	2	0	3
test_AA10.6.NonSyn.01	TYRO1	3	4	0	7
test_AA10.6.NonSyn.01	VLCAD	23	19	0	42
AA10.2_batch2	3MCC	6	6	1	13
AA10.2_batch2	ARG	2	0	0	2
AA10.2_batch2	CIT	7	2	0	9
AA10.2_batch2	CPT I	1	0	0	1
AA10.2_batch2	CPT II	0	1	0	1
AA10.2_batch2	CTD	7	1	0	8
AA10.2_batch2	GA-I	8	0	0	8
AA10.2_batch2	GA2	1	1	0	2
AA10.2_batch2	HCY	1	0	0	1
AA10.2_batch2	IVA	13	0	0	13
AA10.2_batch2	LCHAD	2	0	0	2
AA10.2_batch2	MAL	0	1	0	1
AA10.2_batch2	MCAD	40	0	0	40
AA10.2_batch2	MSUD	3	0	0	3
AA10.2_batch2	OTC	5	2	0	7
AA10.2_batch2	PA/MMA	13	1	0	14
AA10.2_batch2	PKU	59	2	0	61
AA10.2_batch2	RMD	3	0	0	3
AA10.2_batch2	SCAD	9	21	1	31
AA10.2_batch2	TFP	1	0	0	1
AA10.2_batch2	TYRO1	1	0	0	1
AA10.2_batch2	VLCAD	5	0	0	5
AA10.1_batch3	3MCC	13	4	0	17
AA10.1_batch3	ARG	2	0	0	2
AA10.1_batch3	BKT	2	0	0	2
AA10.1_batch3	CIT	16	1	0	17
AA10.1_batch3	CPT II	5	2	0	7
AA10.1_batch3	CTD	20	8	2	30
AA10.1_batch3	GA-I	22	4	1	27
AA10.1_batch3	GA2	5	1	0	6
AA10.1_batch3	HCY	7	2	1	10
AA10.1_batch3	HYPRO	0	3	0	3
AA10.1_batch3	IVA	18	5	1	24
AA10.1_batch3	LCHAD	7	0	0	7
AA10.1_batch3	MAL	2	3	0	5
AA10.1_batch3	MCAD	106	10	1	117
AA10.1_batch3	MCD	1	3	0	4
AA10.1_batch3	MSUD	16	3	0	19
AA10.1_batch3	OTC	4	0	0	4
AA10.1_batch3	PA/MMA	52	14	1	67
AA10.1_batch3	PKU	25	6	0	31
AA10.1_batch3	SCAD	22	12	2	36
AA10.1_batch3	TFP	2	0	0	2
AA10.1_batch3	TYRO1	6	0	0	6
AA10.1_batch3	VLCAD	31	6	0	37
val_AA10.8_batch1	3MCC	3	12	0	15
val_AA10.8_batch1	BKT	0	1	0	1
val_AA10.8_batch1	CIT	4	3	0	7
val_AA10.8_batch1	CTD	5	4	0	9
val_AA10.8_batch1	GA-I	0	1	0	1
val_AA10.8_batch1	GA2	2	2	0	4
val_AA10.8_batch1	HCY	0	1	0	1
val_AA10.8_batch1	IVA	1	2	0	3
val_AA10.8_batch1	MCAD	5	12	0	17
val_AA10.8_batch1	MCD	0	1	0	1
val_AA10.8_batch1	MSUD	1	2	0	3
val_AA10.8_batch1	OTC	1	4	0	5
val_AA10.8_batch1	PA/MMA	5	4	0	9
val_AA10.8_batch1	PKU	36	3	0	39
val_AA10.8_batch1	SCAD	2	15	0	17
val_AA10.8_batch1	TFP	0	1	0	1
val_AA10.8_batch1	VLCAD	3	2	0	5
test_AA10.6.NonSyn.005_filter4	3MCC	3	10	0	13
test_AA10.6.NonSyn.005_filter4	ARG	1	0	0	1
test_AA10.6.NonSyn.005_filter4	BKT	0	2	0	2
test_AA10.6.NonSyn.005_filter4	CIT	9	5	0	14
test_AA10.6.NonSyn.005_filter4	CPT II	1	5	0	6
test_AA10.6.NonSyn.005_filter4	CTD	9	13	2	24
test_AA10.6.NonSyn.005_filter4	GA-I	14	9	0	23
test_AA10.6.NonSyn.005_filter4	GA2	3	2	0	5
test_AA10.6.NonSyn.005_filter4	HCY	3	3	1	7
test_AA10.6.NonSyn.005_filter4	HYPRO	0	1	0	1
test_AA10.6.NonSyn.005_filter4	IVA	8	11	1	20
test_AA10.6.NonSyn.005_filter4	LCHAD	2	4	0	6
test_AA10.6.NonSyn.005_filter4	MAL	1	2	0	3
test_AA10.6.NonSyn.005_filter4	MCAD	71	25	1	97
test_AA10.6.NonSyn.005_filter4	MCD	1	2	0	3
test_AA10.6.NonSyn.005_filter4	MSUD	6	4	0	10
test_AA10.6.NonSyn.005_filter4	OTC	4	1	0	5
test_AA10.6.NonSyn.005_filter4	PA/MMA	11	39	2	52
test_AA10.6.NonSyn.005_filter4	PKU	14	11	0	25
test_AA10.6.NonSyn.005_filter4	SCAD	17	13	1	31
test_AA10.6.NonSyn.005_filter4	TFP	1	2	0	3
test_AA10.6.NonSyn.005_filter4	TYRO1	3	3	0	6
test_AA10.6.NonSyn.005_filter4	VLCAD	14	13	0	27
test_AA10.6.NonSyn.02_filter2	3MCC	10	14	2	26
test_AA10.6.NonSyn.02_filter2	ARG	1	1	1	3
test_AA10.6.NonSyn.02_filter2	BKT	0	2	0	2
test_AA10.6.NonSyn.02_filter2	CIT	15	7	0	22
test_AA10.6.NonSyn.02_filter2	CPT I	0	1	0	1
test_AA10.6.NonSyn.02_filter2	CPT II	1	6	1	8
test_AA10.6.NonSyn.02_filter2	CTD	15	14	4	33
test_AA10.6.NonSyn.02_filter2	GA-I	19	10	1	30
test_AA10.6.NonSyn.02_filter2	GA2	4	3	0	7
test_AA10.6.NonSyn.02_filter2	HCY	4	3	2	9
test_AA10.6.NonSyn.02_filter2	HYPRO	0	2	0	2
test_AA10.6.NonSyn.02_filter2	IVA	16	13	2	31
test_AA10.6.NonSyn.02_filter2	LCHAD	2	6	1	9
test_AA10.6.NonSyn.02_filter2	MAL	1	5	0	6
test_AA10.6.NonSyn.02_filter2	MCAD	103	31	4	138
test_AA10.6.NonSyn.02_filter2	MCD	1	2	0	3
test_AA10.6.NonSyn.02_filter2	MSUD	12	9	1	22
test_AA10.6.NonSyn.02_filter2	OTC	6	3	0	9
test_AA10.6.NonSyn.02_filter2	PA/MMA	18	48	4	70
test_AA10.6.NonSyn.02_filter2	PKU	36	39	1	76
test_AA10.6.NonSyn.02_filter2	RMD	1	0	0	1
test_AA10.6.NonSyn.02_filter2	SCAD	23	33	4	60
test_AA10.6.NonSyn.02_filter2	TFP	1	2	0	3
test_AA10.6.NonSyn.02_filter2	TYRO1	3	3	0	6
test_AA10.6.NonSyn.02_filter2	VLCAD	19	17	0	36
AA10.6_batch1	3MCC	14	1	0	15
AA10.6_batch1	BKT	1	0	0	1
AA10.6_batch1	CIT	5	2	0	7
AA10.6_batch1	CTD	9	0	0	9
AA10.6_batch1	GA-I	1	0	0	1
AA10.6_batch1	GA2	3	1	0	4
AA10.6_batch1	HCY	0	1	0	1
AA10.6_batch1	IVA	1	2	0	3
AA10.6_batch1	MCAD	16	1	0	17
AA10.6_batch1	MCD	1	0	0	1
AA10.6_batch1	MSUD	1	1	1	3
AA10.6_batch1	OTC	3	2	0	5
AA10.6_batch1	PA/MMA	7	2	0	9
AA10.6_batch1	PKU	37	2	0	39
AA10.6_batch1	SCAD	9	8	0	17
AA10.6_batch1	TFP	1	0	0	1
AA10.6_batch1	VLCAD	4	1	0	5
test_AA10.5_filter1	3MCC	7	20	0	27
test_AA10.5_filter1	ARG	1	2	0	3
test_AA10.5_filter1	BKT	0	2	0	2
test_AA10.5_filter1	CIT	12	11	0	23
test_AA10.5_filter1	CPT I	1	0	0	1
test_AA10.5_filter1	CPT II	3	5	0	8
test_AA10.5_filter1	CTD	16	16	2	34
test_AA10.5_filter1	GA-I	17	14	0	31
test_AA10.5_filter1	GA2	3	4	0	7
test_AA10.5_filter1	HCY	4	5	1	10
test_AA10.5_filter1	HYPRO	0	2	0	2
test_AA10.5_filter1	IVA	15	16	2	33
test_AA10.5_filter1	LCHAD	5	4	0	9
test_AA10.5_filter1	MAL	1	5	0	6
test_AA10.5_filter1	MCAD	80	60	3	143
test_AA10.5_filter1	MCD	1	2	0	3
test_AA10.5_filter1	MSUD	10	12	0	22
test_AA10.5_filter1	OTC	7	2	0	9
test_AA10.5_filter1	PA/MMA	49	24	0	73
test_AA10.5_filter1	PKU	72	7	0	79
test_AA10.5_filter1	RMD	1	0	0	1
test_AA10.5_filter1	SCAD	15	46	2	63
test_AA10.5_filter1	TFP	1	2	0	3
test_AA10.5_filter1	TYRO1	6	1	0	7
test_AA10.5_filter1	VLCAD	18	21	0	39
val_AA10.6.NonSyn.02_filter1	3MCC	8	7	0	15
val_AA10.6.NonSyn.02_filter1	BKT	1	0	0	1
val_AA10.6.NonSyn.02_filter1	CIT	2	3	1	6
val_AA10.6.NonSyn.02_filter1	CTD	4	4	1	9
val_AA10.6.NonSyn.02_filter1	GA-I	1	0	0	1
val_AA10.6.NonSyn.02_filter1	GA2	3	1	0	4
val_AA10.6.NonSyn.02_filter1	HCY	0	1	0	1
val_AA10.6.NonSyn.02_filter1	IVA	1	1	1	3
val_AA10.6.NonSyn.02_filter1	MCAD	14	3	0	17
val_AA10.6.NonSyn.02_filter1	MCD	0	1	0	1
val_AA10.6.NonSyn.02_filter1	MSUD	1	1	1	3
val_AA10.6.NonSyn.02_filter1	OTC	3	2	0	5
val_AA10.6.NonSyn.02_filter1	PA/MMA	4	5	0	9
val_AA10.6.NonSyn.02_filter1	PKU	22	16	1	39
val_AA10.6.NonSyn.02_filter1	SCAD	8	9	0	17
val_AA10.6.NonSyn.02_filter1	TFP	0	1	0	1
val_AA10.6.NonSyn.02_filter1	VLCAD	2	3	0	5
AA10.5	3MCC	11	34	0	45
AA10.5	ARG	2	2	0	4
AA10.5	BKT	0	3	0	3
AA10.5	CIT	18	15	0	33
AA10.5	CPT I	1	0	0	1
AA10.5	CPT II	3	5	0	8
AA10.5	CTD	24	21	2	47
AA10.5	GA-I	20	15	1	36
AA10.5	GA2	5	7	0	12
AA10.5	HCY	5	6	1	12
AA10.5	HYPRO	0	3	0	3
AA10.5	IVA	21	17	2	40
AA10.5	LCHAD	5	4	0	9
AA10.5	MAL	1	5	0	6
AA10.5	MCAD	92	79	3	174
AA10.5	MCD	1	4	0	5
AA10.5	MSUD	11	14	0	25
AA10.5	OTC	9	7	0	16
AA10.5	PA/MMA	61	29	0	90
AA10.5	PKU	120	11	0	131
AA10.5	RMD	3	0	0	3
AA10.5	SCAD	21	61	2	84
AA10.5	TFP	1	3	0	4
AA10.5	TYRO1	6	1	0	7
AA10.5	VLCAD	23	24	0	47
AA10.6.NonSyn.02_filter3	3MCC	15	16	2	33
AA10.6.NonSyn.02_filter3	ARG	1	1	1	3
AA10.6.NonSyn.02_filter3	BKT	0	2	0	2
AA10.6.NonSyn.02_filter3	CIT	17	9	1	27
AA10.6.NonSyn.02_filter3	CPT I	0	1	0	1
AA10.6.NonSyn.02_filter3	CPT II	1	4	1	6
AA10.6.NonSyn.02_filter3	CTD	16	18	4	38
AA10.6.NonSyn.02_filter3	GA-I	17	10	1	28
AA10.6.NonSyn.02_filter3	GA2	6	3	0	9
AA10.6.NonSyn.02_filter3	HCY	4	4	1	9
AA10.6.NonSyn.02_filter3	HYPRO	0	2	0	2
AA10.6.NonSyn.02_filter3	IVA	13	13	3	29
AA10.6.NonSyn.02_filter3	LCHAD	2	4	1	7
AA10.6.NonSyn.02_filter3	MAL	1	5	0	6
AA10.6.NonSyn.02_filter3	MCAD	105	31	4	140
AA10.6.NonSyn.02_filter3	MCD	1	3	0	4
AA10.6.NonSyn.02_filter3	MSUD	12	8	0	20
AA10.6.NonSyn.02_filter3	OTC	7	2	0	9
AA10.6.NonSyn.02_filter3	PA/MMA	20	50	3	73
AA10.6.NonSyn.02_filter3	PKU	44	43	1	88
AA10.6.NonSyn.02_filter3	SCAD	28	35	4	67
AA10.6.NonSyn.02_filter3	TFP	1	3	0	4
AA10.6.NonSyn.02_filter3	TYRO1	3	3	0	6
AA10.6.NonSyn.02_filter3	VLCAD	20	19	0	39
val_AA10.9.NoOneGene_filter4	3MCC	11	0	0	11
val_AA10.9.NoOneGene_filter4	CIT	3	2	0	5
val_AA10.9.NoOneGene_filter4	CTD	9	0	0	9
val_AA10.9.NoOneGene_filter4	GA-I	1	0	0	1
val_AA10.9.NoOneGene_filter4	GA2	2	0	0	2
val_AA10.9.NoOneGene_filter4	HCY	1	0	0	1
val_AA10.9.NoOneGene_filter4	IVA	2	0	0	2
val_AA10.9.NoOneGene_filter4	MCAD	11	1	0	12
val_AA10.9.NoOneGene_filter4	MCD	1	0	0	1
val_AA10.9.NoOneGene_filter4	MSUD	1	1	0	2
val_AA10.9.NoOneGene_filter4	OTC	3	0	0	3
val_AA10.9.NoOneGene_filter4	PA/MMA	9	0	0	9
val_AA10.9.NoOneGene_filter4	PKU	32	0	0	32
val_AA10.9.NoOneGene_filter4	SCAD	8	7	0	15
val_AA10.9.NoOneGene_filter4	TFP	1	0	0	1
val_AA10.9.NoOneGene_filter4	VLCAD	4	0	0	4
val_AA10.2_filter3	3MCC	11	0	0	11
val_AA10.2_filter3	CIT	3	2	0	5
val_AA10.2_filter3	CTD	9	0	0	9
val_AA10.2_filter3	GA-I	1	0	0	1
val_AA10.2_filter3	GA2	2	0	0	2
val_AA10.2_filter3	HCY	1	0	0	1
val_AA10.2_filter3	IVA	2	0	0	2
val_AA10.2_filter3	MCAD	11	1	0	12
val_AA10.2_filter3	MCD	1	0	0	1
val_AA10.2_filter3	MSUD	1	1	0	2
val_AA10.2_filter3	OTC	3	0	0	3
val_AA10.2_filter3	PA/MMA	9	0	0	9
val_AA10.2_filter3	PKU	32	0	0	32
val_AA10.2_filter3	SCAD	8	7	0	15
val_AA10.2_filter3	TFP	1	0	0	1
val_AA10.2_filter3	VLCAD	4	0	0	4
test_AA10.6.NonSyn.01_filter3	3MCC	8	13	1	22
test_AA10.6.NonSyn.01_filter3	ARG	1	1	1	3
test_AA10.6.NonSyn.01_filter3	BKT	0	2	0	2
test_AA10.6.NonSyn.01_filter3	CIT	15	7	0	22
test_AA10.6.NonSyn.01_filter3	CPT I	0	1	0	1
test_AA10.6.NonSyn.01_filter3	CPT II	1	5	0	6
test_AA10.6.NonSyn.01_filter3	CTD	12	14	3	29
test_AA10.6.NonSyn.01_filter3	GA-I	16	11	0	27
test_AA10.6.NonSyn.01_filter3	GA2	4	3	0	7
test_AA10.6.NonSyn.01_filter3	HCY	4	3	1	8
test_AA10.6.NonSyn.01_filter3	HYPRO	0	2	0	2
test_AA10.6.NonSyn.01_filter3	IVA	13	12	2	27
test_AA10.6.NonSyn.01_filter3	LCHAD	2	4	1	7
test_AA10.6.NonSyn.01_filter3	MAL	1	5	0	6
test_AA10.6.NonSyn.01_filter3	MCAD	95	32	1	128
test_AA10.6.NonSyn.01_filter3	MCD	1	2	0	3
test_AA10.6.NonSyn.01_filter3	MSUD	11	7	0	18
test_AA10.6.NonSyn.01_filter3	OTC	5	1	0	6
test_AA10.6.NonSyn.01_filter3	PA/MMA	16	46	2	64
test_AA10.6.NonSyn.01_filter3	PKU	27	28	1	56
test_AA10.6.NonSyn.01_filter3	SCAD	20	29	3	52
test_AA10.6.NonSyn.01_filter3	TFP	1	2	0	3
test_AA10.6.NonSyn.01_filter3	TYRO1	3	3	0	6
test_AA10.6.NonSyn.01_filter3	VLCAD	18	17	0	35
AA10.5_batch2	3MCC	2	11	0	13
AA10.5_batch2	ARG	1	1	0	2
AA10.5_batch2	CIT	5	4	0	9
AA10.5_batch2	CPT I	1	0	0	1
AA10.5_batch2	CPT II	0	1	0	1
AA10.5_batch2	CTD	5	3	0	8
AA10.5_batch2	GA-I	6	2	0	8
AA10.5_batch2	GA2	0	2	0	2
AA10.5_batch2	HCY	0	1	0	1
AA10.5_batch2	IVA	7	5	1	13
AA10.5_batch2	LCHAD	1	1	0	2
AA10.5_batch2	MAL	0	1	0	1
AA10.5_batch2	MCAD	23	17	0	40
AA10.5_batch2	MSUD	2	1	0	3
AA10.5_batch2	OTC	3	4	0	7
AA10.5_batch2	PA/MMA	11	3	0	14
AA10.5_batch2	PKU	58	3	0	61
AA10.5_batch2	RMD	3	0	0	3
AA10.5_batch2	SCAD	4	26	1	31
AA10.5_batch2	TFP	0	1	0	1
AA10.5_batch2	TYRO1	1	0	0	1
AA10.5_batch2	VLCAD	1	4	0	5
val_AA10.8_filter1	3MCC	3	12	0	15
val_AA10.8_filter1	BKT	0	1	0	1
val_AA10.8_filter1	CIT	3	3	0	6
val_AA10.8_filter1	CTD	5	4	0	9
val_AA10.8_filter1	GA-I	0	1	0	1
val_AA10.8_filter1	GA2	2	2	0	4
val_AA10.8_filter1	HCY	0	1	0	1
val_AA10.8_filter1	IVA	1	2	0	3
val_AA10.8_filter1	MCAD	5	12	0	17
val_AA10.8_filter1	MCD	0	1	0	1
val_AA10.8_filter1	MSUD	1	2	0	3
val_AA10.8_filter1	OTC	1	4	0	5
val_AA10.8_filter1	PA/MMA	5	4	0	9
val_AA10.8_filter1	PKU	36	3	0	39
val_AA10.8_filter1	SCAD	2	15	0	17
val_AA10.8_filter1	TFP	0	1	0	1
val_AA10.8_filter1	VLCAD	3	2	0	5
test_AA10.2	3MCC	19	10	1	30
test_AA10.2	ARG	4	0	0	4
test_AA10.2	BKT	2	0	0	2
test_AA10.2	CIT	23	3	0	26
test_AA10.2	CPT I	1	0	0	1
test_AA10.2	CPT II	5	3	0	8
test_AA10.2	CTD	27	9	2	38
test_AA10.2	GA-I	30	4	1	35
test_AA10.2	GA2	6	2	0	8
test_AA10.2	HCY	8	2	1	11
test_AA10.2	HYPRO	0	3	0	3
test_AA10.2	IVA	31	5	1	37
test_AA10.2	LCHAD	9	0	0	9
test_AA10.2	MAL	2	4	0	6
test_AA10.2	MCAD	146	10	1	157
test_AA10.2	MCD	1	3	0	4
test_AA10.2	MSUD	20	2	0	22
test_AA10.2	OTC	9	2	0	11
test_AA10.2	PA/MMA	65	15	1	81
test_AA10.2	PKU	84	8	0	92
test_AA10.2	RMD	3	0	0	3
test_AA10.2	SCAD	31	33	3	67
test_AA10.2	TFP	3	0	0	3
test_AA10.2	TYRO1	7	0	0	7
test_AA10.2	VLCAD	36	6	0	42
AA10.2_batch3	3MCC	13	4	0	17
AA10.2_batch3	ARG	2	0	0	2
AA10.2_batch3	BKT	2	0	0	2
AA10.2_batch3	CIT	16	1	0	17
AA10.2_batch3	CPT II	5	2	0	7
AA10.2_batch3	CTD	20	8	2	30
AA10.2_batch3	GA-I	22	4	1	27
AA10.2_batch3	GA2	5	1	0	6
AA10.2_batch3	HCY	7	2	1	10
AA10.2_batch3	HYPRO	0	3	0	3
AA10.2_batch3	IVA	18	5	1	24
AA10.2_batch3	LCHAD	7	0	0	7
AA10.2_batch3	MAL	2	3	0	5
AA10.2_batch3	MCAD	106	10	1	117
AA10.2_batch3	MCD	1	3	0	4
AA10.2_batch3	MSUD	17	2	0	19
AA10.2_batch3	OTC	4	0	0	4
AA10.2_batch3	PA/MMA	52	14	1	67
AA10.2_batch3	PKU	25	6	0	31
AA10.2_batch3	SCAD	22	12	2	36
AA10.2_batch3	TFP	2	0	0	2
AA10.2_batch3	TYRO1	6	0	0	6
AA10.2_batch3	VLCAD	31	6	0	37
AA10.4_filter3	3MCC	25	7	1	33
AA10.4_filter3	ARG	3	0	0	3
AA10.4_filter3	BKT	2	0	0	2
AA10.4_filter3	CIT	23	4	0	27
AA10.4_filter3	CPT I	1	0	0	1
AA10.4_filter3	CPT II	3	3	0	6
AA10.4_filter3	CTD	28	8	2	38
AA10.4_filter3	GA-I	24	4	0	28
AA10.4_filter3	GA2	8	1	0	9
AA10.4_filter3	HCY	5	3	1	9
AA10.4_filter3	HYPRO	0	2	0	2
AA10.4_filter3	IVA	24	4	1	29
AA10.4_filter3	LCHAD	7	0	0	7
AA10.4_filter3	MAL	2	4	0	6
AA10.4_filter3	MCAD	124	14	2	140
AA10.4_filter3	MCD	2	2	0	4
AA10.4_filter3	MSUD	18	2	0	20
AA10.4_filter3	OTC	9	0	0	9
AA10.4_filter3	PA/MMA	59	13	1	73
AA10.4_filter3	PKU	82	6	0	88
AA10.4_filter3	SCAD	33	33	1	67
AA10.4_filter3	TFP	4	0	0	4
AA10.4_filter3	TYRO1	6	0	0	6
AA10.4_filter3	VLCAD	31	8	0	39
AA10.6.NonSyn.01_filter3	3MCC	15	17	1	33
AA10.6.NonSyn.01_filter3	ARG	1	1	1	3
AA10.6.NonSyn.01_filter3	BKT	0	2	0	2
AA10.6.NonSyn.01_filter3	CIT	17	9	1	27
AA10.6.NonSyn.01_filter3	CPT I	0	1	0	1
AA10.6.NonSyn.01_filter3	CPT II	1	5	0	6
AA10.6.NonSyn.01_filter3	CTD	16	18	4	38
AA10.6.NonSyn.01_filter3	GA-I	17	11	0	28
AA10.6.NonSyn.01_filter3	GA2	6	3	0	9
AA10.6.NonSyn.01_filter3	HCY	4	4	1	9
AA10.6.NonSyn.01_filter3	HYPRO	0	2	0	2
AA10.6.NonSyn.01_filter3	IVA	13	14	2	29
AA10.6.NonSyn.01_filter3	LCHAD	2	4	1	7
AA10.6.NonSyn.01_filter3	MAL	1	5	0	6
AA10.6.NonSyn.01_filter3	MCAD	105	34	1	140
AA10.6.NonSyn.01_filter3	MCD	1	3	0	4
AA10.6.NonSyn.01_filter3	MSUD	12	8	0	20
AA10.6.NonSyn.01_filter3	OTC	7	2	0	9
AA10.6.NonSyn.01_filter3	PA/MMA	20	51	2	73
AA10.6.NonSyn.01_filter3	PKU	44	43	1	88
AA10.6.NonSyn.01_filter3	SCAD	27	37	3	67
AA10.6.NonSyn.01_filter3	TFP	1	3	0	4
AA10.6.NonSyn.01_filter3	TYRO1	3	3	0	6
AA10.6.NonSyn.01_filter3	VLCAD	20	19	0	39
AA10.6_filter2	3MCC	30	10	1	41
AA10.6_filter2	ARG	3	0	0	3
AA10.6_filter2	BKT	3	0	0	3
AA10.6_filter2	CIT	24	4	0	28
AA10.6_filter2	CPT I	1	0	0	1
AA10.6_filter2	CPT II	5	3	0	8
AA10.6_filter2	CTD	32	8	2	42
AA10.6_filter2	GA-I	27	4	0	31
AA10.6_filter2	GA2	9	2	0	11
AA10.6_filter2	HCY	5	3	2	10
AA10.6_filter2	HYPRO	0	2	0	2
AA10.6_filter2	IVA	25	8	1	34
AA10.6_filter2	LCHAD	9	0	0	9
AA10.6_filter2	MAL	2	4	0	6
AA10.6_filter2	MCAD	138	16	1	155
AA10.6_filter2	MCD	2	2	0	4
AA10.6_filter2	MSUD	19	4	2	25
AA10.6_filter2	OTC	11	3	0	14
AA10.6_filter2	PA/MMA	62	16	1	79
AA10.6_filter2	PKU	108	7	0	115
AA10.6_filter2	RMD	1	0	0	1
AA10.6_filter2	SCAD	37	38	2	77
AA10.6_filter2	TFP	4	0	0	4
AA10.6_filter2	TYRO1	6	0	0	6
AA10.6_filter2	VLCAD	32	9	0	41
val_AA10.6.NonSyn.01_batch1	3MCC	8	7	0	15
val_AA10.6.NonSyn.01_batch1	BKT	1	0	0	1
val_AA10.6.NonSyn.01_batch1	CIT	3	3	1	7
val_AA10.6.NonSyn.01_batch1	CTD	4	4	1	9
val_AA10.6.NonSyn.01_batch1	GA-I	1	0	0	1
val_AA10.6.NonSyn.01_batch1	GA2	3	1	0	4
val_AA10.6.NonSyn.01_batch1	HCY	0	1	0	1
val_AA10.6.NonSyn.01_batch1	IVA	1	2	0	3
val_AA10.6.NonSyn.01_batch1	MCAD	14	3	0	17
val_AA10.6.NonSyn.01_batch1	MCD	0	1	0	1
val_AA10.6.NonSyn.01_batch1	MSUD	1	1	1	3
val_AA10.6.NonSyn.01_batch1	OTC	3	2	0	5
val_AA10.6.NonSyn.01_batch1	PA/MMA	4	5	0	9
val_AA10.6.NonSyn.01_batch1	PKU	22	17	0	39
val_AA10.6.NonSyn.01_batch1	SCAD	8	9	0	17
val_AA10.6.NonSyn.01_batch1	TFP	0	1	0	1
val_AA10.6.NonSyn.01_batch1	VLCAD	2	3	0	5
val_AA10.2	3MCC	14	1	0	15
val_AA10.2	BKT	1	0	0	1
val_AA10.2	CIT	5	2	0	7
val_AA10.2	CTD	9	0	0	9
val_AA10.2	GA-I	1	0	0	1
val_AA10.2	GA2	3	1	0	4
val_AA10.2	HCY	1	0	0	1
val_AA10.2	IVA	3	0	0	3
val_AA10.2	MCAD	16	1	0	17
val_AA10.2	MCD	1	0	0	1
val_AA10.2	MSUD	2	1	0	3
val_AA10.2	OTC	4	1	0	5
val_AA10.2	PA/MMA	9	0	0	9
val_AA10.2	PKU	39	0	0	39
val_AA10.2	SCAD	9	8	0	17
val_AA10.2	TFP	1	0	0	1
val_AA10.2	VLCAD	5	0	0	5
AA10.6.NonSyn.01	3MCC	21	23	1	45
AA10.6.NonSyn.01	ARG	1	2	1	4
AA10.6.NonSyn.01	BKT	1	2	0	3
AA10.6.NonSyn.01	CIT	19	12	2	33
AA10.6.NonSyn.01	CPT I	0	1	0	1
AA10.6.NonSyn.01	CPT II	1	7	0	8
AA10.6.NonSyn.01	CTD	22	21	4	47
AA10.6.NonSyn.01	GA-I	24	12	0	36
AA10.6.NonSyn.01	GA2	7	5	0	12
AA10.6.NonSyn.01	HCY	5	5	2	12
AA10.6.NonSyn.01	HYPRO	0	3	0	3
AA10.6.NonSyn.01	IVA	23	15	2	40
AA10.6.NonSyn.01	LCHAD	2	6	1	9
AA10.6.NonSyn.01	MAL	1	5	0	6
AA10.6.NonSyn.01	MCAD	132	41	1	174
AA10.6.NonSyn.01	MCD	1	4	0	5
AA10.6.NonSyn.01	MSUD	13	10	2	25
AA10.6.NonSyn.01	OTC	10	6	0	16
AA10.6.NonSyn.01	PA/MMA	24	62	4	90
AA10.6.NonSyn.01	PKU	65	65	1	131
AA10.6.NonSyn.01	RMD	1	2	0	3
AA10.6.NonSyn.01	SCAD	31	50	3	84
AA10.6.NonSyn.01	TFP	1	3	0	4
AA10.6.NonSyn.01	TYRO1	3	4	0	7
AA10.6.NonSyn.01	VLCAD	25	22	0	47
AA10.3_filter1	3MCC	31	10	1	42
AA10.3_filter1	ARG	3	0	0	3
AA10.3_filter1	BKT	3	0	0	3
AA10.3_filter1	CIT	25	4	0	29
AA10.3_filter1	CPT I	1	0	0	1
AA10.3_filter1	CPT II	5	3	0	8
AA10.3_filter1	CTD	34	7	2	43
AA10.3_filter1	GA-I	28	4	0	32
AA10.3_filter1	GA2	9	2	0	11
AA10.3_filter1	HCY	9	1	1	11
AA10.3_filter1	HYPRO	0	2	0	2
AA10.3_filter1	IVA	27	8	1	36
AA10.3_filter1	LCHAD	9	0	0	9
AA10.3_filter1	MAL	2	4	0	6
AA10.3_filter1	MCAD	147	13	0	160
AA10.3_filter1	MCD	2	2	0	4
AA10.3_filter1	MSUD	21	4	0	25
AA10.3_filter1	OTC	11	3	0	14
AA10.3_filter1	PA/MMA	66	15	1	82
AA10.3_filter1	PKU	112	6	0	118
AA10.3_filter1	RMD	1	0	0	1
AA10.3_filter1	SCAD	40	37	3	80
AA10.3_filter1	TFP	4	0	0	4
AA10.3_filter1	TYRO1	7	0	0	7
AA10.3_filter1	VLCAD	38	6	0	44
val_AA10.1_filter1	3MCC	14	1	0	15
val_AA10.1_filter1	BKT	1	0	0	1
val_AA10.1_filter1	CIT	4	2	0	6
val_AA10.1_filter1	CTD	9	0	0	9
val_AA10.1_filter1	GA-I	1	0	0	1
val_AA10.1_filter1	GA2	3	1	0	4
val_AA10.1_filter1	HCY	1	0	0	1
val_AA10.1_filter1	IVA	3	0	0	3
val_AA10.1_filter1	MCAD	16	1	0	17
val_AA10.1_filter1	MCD	1	0	0	1
val_AA10.1_filter1	MSUD	2	1	0	3
val_AA10.1_filter1	OTC	4	1	0	5
val_AA10.1_filter1	PA/MMA	9	0	0	9
val_AA10.1_filter1	PKU	39	0	0	39
val_AA10.1_filter1	SCAD	9	8	0	17
val_AA10.1_filter1	TFP	1	0	0	1
val_AA10.1_filter1	VLCAD	5	0	0	5
AA10.7_batch1	3MCC	3	12	0	15
AA10.7_batch1	BKT	0	1	0	1
AA10.7_batch1	CIT	4	3	0	7
AA10.7_batch1	CTD	7	2	0	9
AA10.7_batch1	GA-I	0	1	0	1
AA10.7_batch1	GA2	2	2	0	4
AA10.7_batch1	HCY	1	0	0	1
AA10.7_batch1	IVA	1	2	0	3
AA10.7_batch1	MCAD	5	12	0	17
AA10.7_batch1	MCD	0	1	0	1
AA10.7_batch1	MSUD	1	2	0	3
AA10.7_batch1	OTC	1	4	0	5
AA10.7_batch1	PA/MMA	6	3	0	9
AA10.7_batch1	PKU	37	2	0	39
AA10.7_batch1	SCAD	6	11	0	17
AA10.7_batch1	TFP	0	1	0	1
AA10.7_batch1	VLCAD	3	2	0	5
AA10.4_filter4	3MCC	20	4	0	24
AA10.4_filter4	ARG	1	0	0	1
AA10.4_filter4	BKT	2	0	0	2
AA10.4_filter4	CIT	16	3	0	19
AA10.4_filter4	CPT II	3	3	0	6
AA10.4_filter4	CTD	24	7	2	33
AA10.4_filter4	GA-I	21	3	0	24
AA10.4_filter4	GA2	7	0	0	7
AA10.4_filter4	HCY	4	3	1	8
AA10.4_filter4	HYPRO	0	1	0	1
AA10.4_filter4	IVA	17	4	1	22
AA10.4_filter4	LCHAD	6	0	0	6
AA10.4_filter4	MAL	2	1	0	3
AA10.4_filter4	MCAD	94	13	2	109
AA10.4_filter4	MCD	2	2	0	4
AA10.4_filter4	MSUD	10	2	0	12
AA10.4_filter4	OTC	8	0	0	8
AA10.4_filter4	PA/MMA	48	12	1	61
AA10.4_filter4	PKU	52	5	0	57
AA10.4_filter4	SCAD	29	16	1	46
AA10.4_filter4	TFP	4	0	0	4
AA10.4_filter4	TYRO1	6	0	0	6
AA10.4_filter4	VLCAD	23	8	0	31
AA10.9.NoOneGene_filter3	3MCC	25	7	1	33
AA10.9.NoOneGene_filter3	ARG	3	0	0	3
AA10.9.NoOneGene_filter3	BKT	2	0	0	2
AA10.9.NoOneGene_filter3	CIT	23	4	0	27
AA10.9.NoOneGene_filter3	CPT I	1	0	0	1
AA10.9.NoOneGene_filter3	CPT II	3	3	0	6
AA10.9.NoOneGene_filter3	CTD	30	7	1	38
AA10.9.NoOneGene_filter3	GA-I	24	4	0	28
AA10.9.NoOneGene_filter3	GA2	8	1	0	9
AA10.9.NoOneGene_filter3	HCY	7	1	1	9
AA10.9.NoOneGene_filter3	HYPRO	0	2	0	2
AA10.9.NoOneGene_filter3	IVA	24	4	1	29
AA10.9.NoOneGene_filter3	LCHAD	7	0	0	7
AA10.9.NoOneGene_filter3	MAL	2	4	0	6
AA10.9.NoOneGene_filter3	MCAD	128	11	1	140
AA10.9.NoOneGene_filter3	MCD	2	2	0	4
AA10.9.NoOneGene_filter3	MSUD	18	2	0	20
AA10.9.NoOneGene_filter3	OTC	9	0	0	9
AA10.9.NoOneGene_filter3	PA/MMA	60	12	1	73
AA10.9.NoOneGene_filter3	PKU	83	5	0	88
AA10.9.NoOneGene_filter3	SCAD	33	32	2	67
AA10.9.NoOneGene_filter3	TFP	4	0	0	4
AA10.9.NoOneGene_filter3	TYRO1	6	0	0	6
AA10.9.NoOneGene_filter3	VLCAD	33	6	0	39
AA10.8_batch3	3MCC	6	11	0	17
AA10.8_batch3	ARG	1	1	0	2
AA10.8_batch3	BKT	0	2	0	2
AA10.8_batch3	CIT	9	8	0	17
AA10.8_batch3	CPT II	3	4	0	7
AA10.8_batch3	CTD	13	16	1	30
AA10.8_batch3	GA-I	14	12	1	27
AA10.8_batch3	GA2	3	3	0	6
AA10.8_batch3	HCY	2	7	1	10
AA10.8_batch3	HYPRO	0	3	0	3
AA10.8_batch3	IVA	10	13	1	24
AA10.8_batch3	LCHAD	4	3	0	7
AA10.8_batch3	MAL	1	4	0	5
AA10.8_batch3	MCAD	61	56	0	117
AA10.8_batch3	MCD	1	3	0	4
AA10.8_batch3	MSUD	6	13	0	19
AA10.8_batch3	OTC	4	0	0	4
AA10.8_batch3	PA/MMA	41	26	0	67
AA10.8_batch3	PKU	23	8	0	31
AA10.8_batch3	SCAD	2	34	0	36
AA10.8_batch3	TFP	1	1	0	2
AA10.8_batch3	TYRO1	5	1	0	6
AA10.8_batch3	VLCAD	19	18	0	37
test_AA10.4_batch3	3MCC	13	4	0	17
test_AA10.4_batch3	ARG	2	0	0	2
test_AA10.4_batch3	BKT	2	0	0	2
test_AA10.4_batch3	CIT	16	1	0	17
test_AA10.4_batch3	CPT II	5	2	0	7
test_AA10.4_batch3	CTD	19	9	2	30
test_AA10.4_batch3	GA-I	22	4	1	27
test_AA10.4_batch3	GA2	5	1	0	6
test_AA10.4_batch3	HCY	5	3	2	10
test_AA10.4_batch3	HYPRO	0	3	0	3
test_AA10.4_batch3	IVA	18	5	1	24
test_AA10.4_batch3	LCHAD	7	0	0	7
test_AA10.4_batch3	MAL	2	3	0	5
test_AA10.4_batch3	MCAD	102	13	2	117
test_AA10.4_batch3	MCD	1	3	0	4
test_AA10.4_batch3	MSUD	17	2	0	19
test_AA10.4_batch3	OTC	4	0	0	4
test_AA10.4_batch3	PA/MMA	52	14	1	67
test_AA10.4_batch3	PKU	25	6	0	31
test_AA10.4_batch3	SCAD	21	13	2	36
test_AA10.4_batch3	TFP	2	0	0	2
test_AA10.4_batch3	TYRO1	6	0	0	6
test_AA10.4_batch3	VLCAD	29	8	0	37
val_AA10.7	3MCC	3	12	0	15
val_AA10.7	BKT	0	1	0	1
val_AA10.7	CIT	4	3	0	7
val_AA10.7	CTD	7	2	0	9
val_AA10.7	GA-I	0	1	0	1
val_AA10.7	GA2	2	2	0	4
val_AA10.7	HCY	1	0	0	1
val_AA10.7	IVA	1	2	0	3
val_AA10.7	MCAD	5	12	0	17
val_AA10.7	MCD	0	1	0	1
val_AA10.7	MSUD	1	2	0	3
val_AA10.7	OTC	1	4	0	5
val_AA10.7	PA/MMA	6	3	0	9
val_AA10.7	PKU	37	2	0	39
val_AA10.7	SCAD	6	11	0	17
val_AA10.7	TFP	0	1	0	1
val_AA10.7	VLCAD	3	2	0	5
test_AA10.6.NonSyn.01_batch3	3MCC	7	10	0	17
test_AA10.6.NonSyn.01_batch3	ARG	1	1	0	2
test_AA10.6.NonSyn.01_batch3	BKT	0	2	0	2
test_AA10.6.NonSyn.01_batch3	CIT	10	7	0	17
test_AA10.6.NonSyn.01_batch3	CPT II	1	6	0	7
test_AA10.6.NonSyn.01_batch3	CTD	12	15	3	30
test_AA10.6.NonSyn.01_batch3	GA-I	18	9	0	27
test_AA10.6.NonSyn.01_batch3	GA2	4	2	0	6
test_AA10.6.NonSyn.01_batch3	HCY	4	4	2	10
test_AA10.6.NonSyn.01_batch3	HYPRO	0	3	0	3
test_AA10.6.NonSyn.01_batch3	IVA	12	11	1	24
test_AA10.6.NonSyn.01_batch3	LCHAD	2	5	0	7
test_AA10.6.NonSyn.01_batch3	MAL	1	4	0	5
test_AA10.6.NonSyn.01_batch3	MCAD	86	30	1	117
test_AA10.6.NonSyn.01_batch3	MCD	1	3	0	4
test_AA10.6.NonSyn.01_batch3	MSUD	10	8	1	19
test_AA10.6.NonSyn.01_batch3	OTC	4	0	0	4
test_AA10.6.NonSyn.01_batch3	PA/MMA	16	48	3	67
test_AA10.6.NonSyn.01_batch3	PKU	16	15	0	31
test_AA10.6.NonSyn.01_batch3	SCAD	16	18	2	36
test_AA10.6.NonSyn.01_batch3	TFP	1	1	0	2
test_AA10.6.NonSyn.01_batch3	TYRO1	2	4	0	6
test_AA10.6.NonSyn.01_batch3	VLCAD	21	16	0	37
test_AA10.6.NonSyn.005_batch2	3MCC	6	6	1	13
test_AA10.6.NonSyn.005_batch2	ARG	0	1	1	2
test_AA10.6.NonSyn.005_batch2	CIT	6	2	1	9
test_AA10.6.NonSyn.005_batch2	CPT I	0	1	0	1
test_AA10.6.NonSyn.005_batch2	CPT II	0	1	0	1
test_AA10.6.NonSyn.005_batch2	CTD	6	2	0	8
test_AA10.6.NonSyn.005_batch2	GA-I	5	3	0	8
test_AA10.6.NonSyn.005_batch2	GA2	0	2	0	2
test_AA10.6.NonSyn.005_batch2	HCY	1	0	0	1
test_AA10.6.NonSyn.005_batch2	IVA	10	2	1	13
test_AA10.6.NonSyn.005_batch2	LCHAD	0	2	0	2
test_AA10.6.NonSyn.005_batch2	MAL	0	1	0	1
test_AA10.6.NonSyn.005_batch2	MCAD	32	8	0	40
test_AA10.6.NonSyn.005_batch2	MSUD	2	1	0	3
test_AA10.6.NonSyn.005_batch2	OTC	3	4	0	7
test_AA10.6.NonSyn.005_batch2	PA/MMA	4	10	0	14
test_AA10.6.NonSyn.005_batch2	PKU	27	33	1	61
test_AA10.6.NonSyn.005_batch2	RMD	1	2	0	3
test_AA10.6.NonSyn.005_batch2	SCAD	7	24	0	31
test_AA10.6.NonSyn.005_batch2	TFP	0	1	0	1
test_AA10.6.NonSyn.005_batch2	TYRO1	1	0	0	1
test_AA10.6.NonSyn.005_batch2	VLCAD	2	3	0	5
AA10.9.NoOneGene_batch1	3MCC	14	1	0	15
AA10.9.NoOneGene_batch1	BKT	1	0	0	1
AA10.9.NoOneGene_batch1	CIT	5	2	0	7
AA10.9.NoOneGene_batch1	CTD	9	0	0	9
AA10.9.NoOneGene_batch1	GA-I	1	0	0	1
AA10.9.NoOneGene_batch1	GA2	3	1	0	4
AA10.9.NoOneGene_batch1	HCY	1	0	0	1
AA10.9.NoOneGene_batch1	IVA	3	0	0	3
AA10.9.NoOneGene_batch1	MCAD	16	1	0	17
AA10.9.NoOneGene_batch1	MCD	1	0	0	1
AA10.9.NoOneGene_batch1	MSUD	2	1	0	3
AA10.9.NoOneGene_batch1	OTC	4	1	0	5
AA10.9.NoOneGene_batch1	PA/MMA	9	0	0	9
AA10.9.NoOneGene_batch1	PKU	39	0	0	39
AA10.9.NoOneGene_batch1	SCAD	9	8	0	17
AA10.9.NoOneGene_batch1	TFP	1	0	0	1
AA10.9.NoOneGene_batch1	VLCAD	5	0	0	5
test_AA10.1_filter1	3MCC	17	9	1	27
test_AA10.1_filter1	ARG	3	0	0	3
test_AA10.1_filter1	BKT	2	0	0	2
test_AA10.1_filter1	CIT	21	2	0	23
test_AA10.1_filter1	CPT I	1	0	0	1
test_AA10.1_filter1	CPT II	5	3	0	8
test_AA10.1_filter1	CTD	25	7	2	34
test_AA10.1_filter1	GA-I	27	4	0	31
test_AA10.1_filter1	GA2	6	1	0	7
test_AA10.1_filter1	HCY	8	1	1	10
test_AA10.1_filter1	HYPRO	0	2	0	2
test_AA10.1_filter1	IVA	27	5	1	33
test_AA10.1_filter1	LCHAD	9	0	0	9
test_AA10.1_filter1	MAL	2	4	0	6
test_AA10.1_filter1	MCAD	132	10	1	143
test_AA10.1_filter1	MCD	1	2	0	3
test_AA10.1_filter1	MSUD	19	3	0	22
test_AA10.1_filter1	OTC	8	1	0	9
test_AA10.1_filter1	PA/MMA	59	13	1	73
test_AA10.1_filter1	PKU	73	6	0	79
test_AA10.1_filter1	RMD	1	0	0	1
test_AA10.1_filter1	SCAD	31	29	3	63
test_AA10.1_filter1	TFP	3	0	0	3
test_AA10.1_filter1	TYRO1	7	0	0	7
test_AA10.1_filter1	VLCAD	33	6	0	39
AA10.2_filter1	3MCC	31	10	1	42
AA10.2_filter1	ARG	3	0	0	3
AA10.2_filter1	BKT	3	0	0	3
AA10.2_filter1	CIT	25	4	0	29
AA10.2_filter1	CPT I	1	0	0	1
AA10.2_filter1	CPT II	5	3	0	8
AA10.2_filter1	CTD	34	7	2	43
AA10.2_filter1	GA-I	28	4	0	32
AA10.2_filter1	GA2	9	2	0	11
AA10.2_filter1	HCY	9	1	1	11
AA10.2_filter1	HYPRO	0	2	0	2
AA10.2_filter1	IVA	30	5	1	36
AA10.2_filter1	LCHAD	9	0	0	9
AA10.2_filter1	MAL	2	4	0	6
AA10.2_filter1	MCAD	148	11	1	160
AA10.2_filter1	MCD	2	2	0	4
AA10.2_filter1	MSUD	22	3	0	25
AA10.2_filter1	OTC	12	2	0	14
AA10.2_filter1	PA/MMA	68	13	1	82
AA10.2_filter1	PKU	112	6	0	118
AA10.2_filter1	RMD	1	0	0	1
AA10.2_filter1	SCAD	40	37	3	80
AA10.2_filter1	TFP	4	0	0	4
AA10.2_filter1	TYRO1	7	0	0	7
AA10.2_filter1	VLCAD	38	6	0	44
val_AA10.1	3MCC	14	1	0	15
val_AA10.1	BKT	1	0	0	1
val_AA10.1	CIT	5	2	0	7
val_AA10.1	CTD	9	0	0	9
val_AA10.1	GA-I	1	0	0	1
val_AA10.1	GA2	3	1	0	4
val_AA10.1	HCY	1	0	0	1
val_AA10.1	IVA	3	0	0	3
val_AA10.1	MCAD	16	1	0	17
val_AA10.1	MCD	1	0	0	1
val_AA10.1	MSUD	2	1	0	3
val_AA10.1	OTC	4	1	0	5
val_AA10.1	PA/MMA	9	0	0	9
val_AA10.1	PKU	39	0	0	39
val_AA10.1	SCAD	9	8	0	17
val_AA10.1	TFP	1	0	0	1
val_AA10.1	VLCAD	5	0	0	5
val_AA10.9.NoOneGene_filter1	3MCC	14	1	0	15
val_AA10.9.NoOneGene_filter1	BKT	1	0	0	1
val_AA10.9.NoOneGene_filter1	CIT	4	2	0	6
val_AA10.9.NoOneGene_filter1	CTD	9	0	0	9
val_AA10.9.NoOneGene_filter1	GA-I	1	0	0	1
val_AA10.9.NoOneGene_filter1	GA2	3	1	0	4
val_AA10.9.NoOneGene_filter1	HCY	1	0	0	1
val_AA10.9.NoOneGene_filter1	IVA	3	0	0	3
val_AA10.9.NoOneGene_filter1	MCAD	16	1	0	17
val_AA10.9.NoOneGene_filter1	MCD	1	0	0	1
val_AA10.9.NoOneGene_filter1	MSUD	2	1	0	3
val_AA10.9.NoOneGene_filter1	OTC	4	1	0	5
val_AA10.9.NoOneGene_filter1	PA/MMA	9	0	0	9
val_AA10.9.NoOneGene_filter1	PKU	39	0	0	39
val_AA10.9.NoOneGene_filter1	SCAD	9	8	0	17
val_AA10.9.NoOneGene_filter1	TFP	1	0	0	1
val_AA10.9.NoOneGene_filter1	VLCAD	5	0	0	5
AA10.5_batch3	3MCC	6	11	0	17
AA10.5_batch3	ARG	1	1	0	2
AA10.5_batch3	BKT	0	2	0	2
AA10.5_batch3	CIT	9	8	0	17
AA10.5_batch3	CPT II	3	4	0	7
AA10.5_batch3	CTD	12	16	2	30
AA10.5_batch3	GA-I	14	12	1	27
AA10.5_batch3	GA2	3	3	0	6
AA10.5_batch3	HCY	4	5	1	10
AA10.5_batch3	HYPRO	0	3	0	3
AA10.5_batch3	IVA	11	12	1	24
AA10.5_batch3	LCHAD	4	3	0	7
AA10.5_batch3	MAL	1	4	0	5
AA10.5_batch3	MCAD	64	50	3	117
AA10.5_batch3	MCD	1	3	0	4
AA10.5_batch3	MSUD	8	11	0	19
AA10.5_batch3	OTC	4	0	0	4
AA10.5_batch3	PA/MMA	43	24	0	67
AA10.5_batch3	PKU	25	6	0	31
AA10.5_batch3	SCAD	11	24	1	36
AA10.5_batch3	TFP	1	1	0	2
AA10.5_batch3	TYRO1	5	1	0	6
AA10.5_batch3	VLCAD	19	18	0	37
val_AA10.1_filter2	3MCC	14	1	0	15
val_AA10.1_filter2	BKT	1	0	0	1
val_AA10.1_filter2	CIT	4	2	0	6
val_AA10.1_filter2	CTD	9	0	0	9
val_AA10.1_filter2	GA-I	1	0	0	1
val_AA10.1_filter2	GA2	3	1	0	4
val_AA10.1_filter2	HCY	1	0	0	1
val_AA10.1_filter2	IVA	3	0	0	3
val_AA10.1_filter2	MCAD	16	1	0	17
val_AA10.1_filter2	MCD	1	0	0	1
val_AA10.1_filter2	MSUD	2	1	0	3
val_AA10.1_filter2	OTC	4	1	0	5
val_AA10.1_filter2	PA/MMA	9	0	0	9
val_AA10.1_filter2	PKU	39	0	0	39
val_AA10.1_filter2	SCAD	9	8	0	17
val_AA10.1_filter2	TFP	1	0	0	1
val_AA10.1_filter2	VLCAD	5	0	0	5
test_AA10.2_filter1	3MCC	17	9	1	27
test_AA10.2_filter1	ARG	3	0	0	3
test_AA10.2_filter1	BKT	2	0	0	2
test_AA10.2_filter1	CIT	21	2	0	23
test_AA10.2_filter1	CPT I	1	0	0	1
test_AA10.2_filter1	CPT II	5	3	0	8
test_AA10.2_filter1	CTD	25	7	2	34
test_AA10.2_filter1	GA-I	27	4	0	31
test_AA10.2_filter1	GA2	6	1	0	7
test_AA10.2_filter1	HCY	8	1	1	10
test_AA10.2_filter1	HYPRO	0	2	0	2
test_AA10.2_filter1	IVA	27	5	1	33
test_AA10.2_filter1	LCHAD	9	0	0	9
test_AA10.2_filter1	MAL	2	4	0	6
test_AA10.2_filter1	MCAD	132	10	1	143
test_AA10.2_filter1	MCD	1	2	0	3
test_AA10.2_filter1	MSUD	20	2	0	22
test_AA10.2_filter1	OTC	8	1	0	9
test_AA10.2_filter1	PA/MMA	59	13	1	73
test_AA10.2_filter1	PKU	73	6	0	79
test_AA10.2_filter1	RMD	1	0	0	1
test_AA10.2_filter1	SCAD	31	29	3	63
test_AA10.2_filter1	TFP	3	0	0	3
test_AA10.2_filter1	TYRO1	7	0	0	7
test_AA10.2_filter1	VLCAD	33	6	0	39
val_AA10.7_filter3	3MCC	3	8	0	11
val_AA10.7_filter3	CIT	3	2	0	5
val_AA10.7_filter3	CTD	7	2	0	9
val_AA10.7_filter3	GA-I	0	1	0	1
val_AA10.7_filter3	GA2	1	1	0	2
val_AA10.7_filter3	HCY	1	0	0	1
val_AA10.7_filter3	IVA	0	2	0	2
val_AA10.7_filter3	MCAD	4	8	0	12
val_AA10.7_filter3	MCD	0	1	0	1
val_AA10.7_filter3	MSUD	0	2	0	2
val_AA10.7_filter3	OTC	1	2	0	3
val_AA10.7_filter3	PA/MMA	6	3	0	9
val_AA10.7_filter3	PKU	30	2	0	32
val_AA10.7_filter3	SCAD	5	10	0	15
val_AA10.7_filter3	TFP	0	1	0	1
val_AA10.7_filter3	VLCAD	2	2	0	4
test_AA10.5_filter4	3MCC	3	10	0	13
test_AA10.5_filter4	ARG	0	1	0	1
test_AA10.5_filter4	BKT	0	2	0	2
test_AA10.5_filter4	CIT	8	6	0	14
test_AA10.5_filter4	CPT II	2	4	0	6
test_AA10.5_filter4	CTD	10	12	2	24
test_AA10.5_filter4	GA-I	12	11	0	23
test_AA10.5_filter4	GA2	3	2	0	5
test_AA10.5_filter4	HCY	3	3	1	7
test_AA10.5_filter4	HYPRO	0	1	0	1
test_AA10.5_filter4	IVA	8	11	1	20
test_AA10.5_filter4	LCHAD	3	3	0	6
test_AA10.5_filter4	MAL	1	2	0	3
test_AA10.5_filter4	MCAD	53	42	2	97
test_AA10.5_filter4	MCD	1	2	0	3
test_AA10.5_filter4	MSUD	5	5	0	10
test_AA10.5_filter4	OTC	5	0	0	5
test_AA10.5_filter4	PA/MMA	32	20	0	52
test_AA10.5_filter4	PKU	21	4	0	25
test_AA10.5_filter4	SCAD	11	19	1	31
test_AA10.5_filter4	TFP	1	2	0	3
test_AA10.5_filter4	TYRO1	5	1	0	6
test_AA10.5_filter4	VLCAD	14	13	0	27
test_AA10.9.NoOneGene_batch3	3MCC	13	4	0	17
test_AA10.9.NoOneGene_batch3	ARG	2	0	0	2
test_AA10.9.NoOneGene_batch3	BKT	2	0	0	2
test_AA10.9.NoOneGene_batch3	CIT	16	1	0	17
test_AA10.9.NoOneGene_batch3	CPT II	5	2	0	7
test_AA10.9.NoOneGene_batch3	CTD	21	8	1	30
test_AA10.9.NoOneGene_batch3	GA-I	22	4	1	27
test_AA10.9.NoOneGene_batch3	GA2	5	1	0	6
test_AA10.9.NoOneGene_batch3	HCY	7	2	1	10
test_AA10.9.NoOneGene_batch3	HYPRO	0	3	0	3
test_AA10.9.NoOneGene_batch3	IVA	18	5	1	24
test_AA10.9.NoOneGene_batch3	LCHAD	7	0	0	7
test_AA10.9.NoOneGene_batch3	MAL	2	3	0	5
test_AA10.9.NoOneGene_batch3	MCAD	106	10	1	117
test_AA10.9.NoOneGene_batch3	MCD	1	3	0	4
test_AA10.9.NoOneGene_batch3	MSUD	17	2	0	19
test_AA10.9.NoOneGene_batch3	OTC	4	0	0	4
test_AA10.9.NoOneGene_batch3	PA/MMA	52	14	1	67
test_AA10.9.NoOneGene_batch3	PKU	25	6	0	31
test_AA10.9.NoOneGene_batch3	SCAD	22	12	2	36
test_AA10.9.NoOneGene_batch3	TFP	2	0	0	2
test_AA10.9.NoOneGene_batch3	TYRO1	6	0	0	6
test_AA10.9.NoOneGene_batch3	VLCAD	31	6	0	37
test_AA10.3_filter4	3MCC	9	4	0	13
test_AA10.3_filter4	ARG	1	0	0	1
test_AA10.3_filter4	BKT	2	0	0	2
test_AA10.3_filter4	CIT	13	1	0	14
test_AA10.3_filter4	CPT II	3	3	0	6
test_AA10.3_filter4	CTD	16	6	2	24
test_AA10.3_filter4	GA-I	20	3	0	23
test_AA10.3_filter4	GA2	5	0	0	5
test_AA10.3_filter4	HCY	5	1	1	7
test_AA10.3_filter4	HYPRO	0	1	0	1
test_AA10.3_filter4	IVA	14	5	1	20
test_AA10.3_filter4	LCHAD	6	0	0	6
test_AA10.3_filter4	MAL	2	1	0	3
test_AA10.3_filter4	MCAD	87	10	0	97
test_AA10.3_filter4	MCD	1	2	0	3
test_AA10.3_filter4	MSUD	9	1	0	10
test_AA10.3_filter4	OTC	5	0	0	5
test_AA10.3_filter4	PA/MMA	40	11	1	52
test_AA10.3_filter4	PKU	21	4	0	25
test_AA10.3_filter4	SCAD	21	9	1	31
test_AA10.3_filter4	TFP	3	0	0	3
test_AA10.3_filter4	TYRO1	6	0	0	6
test_AA10.3_filter4	VLCAD	21	6	0	27
val_AA10.6.NonSyn.005_filter2	3MCC	8	7	0	15
val_AA10.6.NonSyn.005_filter2	BKT	1	0	0	1
val_AA10.6.NonSyn.005_filter2	CIT	2	3	1	6
val_AA10.6.NonSyn.005_filter2	CTD	4	4	1	9
val_AA10.6.NonSyn.005_filter2	GA-I	1	0	0	1
val_AA10.6.NonSyn.005_filter2	GA2	3	1	0	4
val_AA10.6.NonSyn.005_filter2	HCY	0	1	0	1
val_AA10.6.NonSyn.005_filter2	IVA	1	2	0	3
val_AA10.6.NonSyn.005_filter2	MCAD	14	3	0	17
val_AA10.6.NonSyn.005_filter2	MCD	0	1	0	1
val_AA10.6.NonSyn.005_filter2	MSUD	1	1	1	3
val_AA10.6.NonSyn.005_filter2	OTC	3	2	0	5
val_AA10.6.NonSyn.005_filter2	PA/MMA	3	6	0	9
val_AA10.6.NonSyn.005_filter2	PKU	22	17	0	39
val_AA10.6.NonSyn.005_filter2	SCAD	8	9	0	17
val_AA10.6.NonSyn.005_filter2	TFP	0	1	0	1
val_AA10.6.NonSyn.005_filter2	VLCAD	2	3	0	5
AA10.3_batch1	3MCC	14	1	0	15
AA10.3_batch1	BKT	1	0	0	1
AA10.3_batch1	CIT	5	2	0	7
AA10.3_batch1	CTD	9	0	0	9
AA10.3_batch1	GA-I	1	0	0	1
AA10.3_batch1	GA2	3	1	0	4
AA10.3_batch1	HCY	1	0	0	1
AA10.3_batch1	IVA	1	2	0	3
AA10.3_batch1	MCAD	16	1	0	17
AA10.3_batch1	MCD	1	0	0	1
AA10.3_batch1	MSUD	2	1	0	3
AA10.3_batch1	OTC	3	2	0	5
AA10.3_batch1	PA/MMA	8	1	0	9
AA10.3_batch1	PKU	39	0	0	39
AA10.3_batch1	SCAD	9	8	0	17
AA10.3_batch1	TFP	1	0	0	1
AA10.3_batch1	VLCAD	5	0	0	5
val_AA10.4_filter4	3MCC	11	0	0	11
val_AA10.4_filter4	CIT	3	2	0	5
val_AA10.4_filter4	CTD	9	0	0	9
val_AA10.4_filter4	GA-I	1	0	0	1
val_AA10.4_filter4	GA2	2	0	0	2
val_AA10.4_filter4	HCY	0	1	0	1
val_AA10.4_filter4	IVA	2	0	0	2
val_AA10.4_filter4	MCAD	11	1	0	12
val_AA10.4_filter4	MCD	1	0	0	1
val_AA10.4_filter4	MSUD	1	1	0	2
val_AA10.4_filter4	OTC	3	0	0	3
val_AA10.4_filter4	PA/MMA	8	1	0	9
val_AA10.4_filter4	PKU	31	1	0	32
val_AA10.4_filter4	SCAD	8	7	0	15
val_AA10.4_filter4	TFP	1	0	0	1
val_AA10.4_filter4	VLCAD	4	0	0	4
AA10.6.NonSyn.005_filter1	3MCC	19	22	1	42
AA10.6.NonSyn.005_filter1	ARG	1	1	1	3
AA10.6.NonSyn.005_filter1	BKT	1	2	0	3
AA10.6.NonSyn.005_filter1	CIT	18	10	1	29
AA10.6.NonSyn.005_filter1	CPT I	0	1	0	1
AA10.6.NonSyn.005_filter1	CPT II	1	7	0	8
AA10.6.NonSyn.005_filter1	CTD	20	20	3	43
AA10.6.NonSyn.005_filter1	GA-I	21	11	0	32
AA10.6.NonSyn.005_filter1	GA2	7	4	0	11
AA10.6.NonSyn.005_filter1	HCY	5	4	2	11
AA10.6.NonSyn.005_filter1	HYPRO	0	2	0	2
AA10.6.NonSyn.005_filter1	IVA	19	15	2	36
AA10.6.NonSyn.005_filter1	LCHAD	2	7	0	9
AA10.6.NonSyn.005_filter1	MAL	1	5	0	6
AA10.6.NonSyn.005_filter1	MCAD	120	39	1	160
AA10.6.NonSyn.005_filter1	MCD	1	3	0	4
AA10.6.NonSyn.005_filter1	MSUD	13	10	2	25
AA10.6.NonSyn.005_filter1	OTC	9	5	0	14
AA10.6.NonSyn.005_filter1	PA/MMA	20	60	2	82
AA10.6.NonSyn.005_filter1	PKU	60	57	1	118
AA10.6.NonSyn.005_filter1	RMD	1	0	0	1
AA10.6.NonSyn.005_filter1	SCAD	31	48	1	80
AA10.6.NonSyn.005_filter1	TFP	1	3	0	4
AA10.6.NonSyn.005_filter1	TYRO1	3	4	0	7
AA10.6.NonSyn.005_filter1	VLCAD	23	21	0	44
AA10.6.NonSyn.02_batch3	3MCC	7	10	0	17
AA10.6.NonSyn.02_batch3	ARG	1	1	0	2
AA10.6.NonSyn.02_batch3	BKT	0	2	0	2
AA10.6.NonSyn.02_batch3	CIT	10	7	0	17
AA10.6.NonSyn.02_batch3	CPT II	1	5	1	7
AA10.6.NonSyn.02_batch3	CTD	12	14	4	30
AA10.6.NonSyn.02_batch3	GA-I	18	8	1	27
AA10.6.NonSyn.02_batch3	GA2	4	2	0	6
AA10.6.NonSyn.02_batch3	HCY	4	4	2	10
AA10.6.NonSyn.02_batch3	HYPRO	0	3	0	3
AA10.6.NonSyn.02_batch3	IVA	12	11	1	24
AA10.6.NonSyn.02_batch3	LCHAD	2	5	0	7
AA10.6.NonSyn.02_batch3	MAL	1	4	0	5
AA10.6.NonSyn.02_batch3	MCAD	86	27	4	117
AA10.6.NonSyn.02_batch3	MCD	1	3	0	4
AA10.6.NonSyn.02_batch3	MSUD	10	8	1	19
AA10.6.NonSyn.02_batch3	OTC	4	0	0	4
AA10.6.NonSyn.02_batch3	PA/MMA	16	47	4	67
AA10.6.NonSyn.02_batch3	PKU	16	14	1	31
AA10.6.NonSyn.02_batch3	SCAD	17	16	3	36
AA10.6.NonSyn.02_batch3	TFP	1	1	0	2
AA10.6.NonSyn.02_batch3	TYRO1	2	4	0	6
AA10.6.NonSyn.02_batch3	VLCAD	21	16	0	37
val_AA10.2_filter4	3MCC	11	0	0	11
val_AA10.2_filter4	CIT	3	2	0	5
val_AA10.2_filter4	CTD	9	0	0	9
val_AA10.2_filter4	GA-I	1	0	0	1
val_AA10.2_filter4	GA2	2	0	0	2
val_AA10.2_filter4	HCY	1	0	0	1
val_AA10.2_filter4	IVA	2	0	0	2
val_AA10.2_filter4	MCAD	11	1	0	12
val_AA10.2_filter4	MCD	1	0	0	1
val_AA10.2_filter4	MSUD	1	1	0	2
val_AA10.2_filter4	OTC	3	0	0	3
val_AA10.2_filter4	PA/MMA	9	0	0	9
val_AA10.2_filter4	PKU	32	0	0	32
val_AA10.2_filter4	SCAD	8	7	0	15
val_AA10.2_filter4	TFP	1	0	0	1
val_AA10.2_filter4	VLCAD	4	0	0	4
val_AA10.3	3MCC	14	1	0	15
val_AA10.3	BKT	1	0	0	1
val_AA10.3	CIT	5	2	0	7
val_AA10.3	CTD	9	0	0	9
val_AA10.3	GA-I	1	0	0	1
val_AA10.3	GA2	3	1	0	4
val_AA10.3	HCY	1	0	0	1
val_AA10.3	IVA	1	2	0	3
val_AA10.3	MCAD	16	1	0	17
val_AA10.3	MCD	1	0	0	1
val_AA10.3	MSUD	2	1	0	3
val_AA10.3	OTC	3	2	0	5
val_AA10.3	PA/MMA	8	1	0	9
val_AA10.3	PKU	39	0	0	39
val_AA10.3	SCAD	9	8	0	17
val_AA10.3	TFP	1	0	0	1
val_AA10.3	VLCAD	5	0	0	5
val_AA10.8_filter2	3MCC	3	12	0	15
val_AA10.8_filter2	BKT	0	1	0	1
val_AA10.8_filter2	CIT	3	3	0	6
val_AA10.8_filter2	CTD	5	4	0	9
val_AA10.8_filter2	GA-I	0	1	0	1
val_AA10.8_filter2	GA2	2	2	0	4
val_AA10.8_filter2	HCY	0	1	0	1
val_AA10.8_filter2	IVA	1	2	0	3
val_AA10.8_filter2	MCAD	5	12	0	17
val_AA10.8_filter2	MCD	0	1	0	1
val_AA10.8_filter2	MSUD	1	2	0	3
val_AA10.8_filter2	OTC	1	4	0	5
val_AA10.8_filter2	PA/MMA	5	4	0	9
val_AA10.8_filter2	PKU	36	3	0	39
val_AA10.8_filter2	SCAD	2	15	0	17
val_AA10.8_filter2	TFP	0	1	0	1
val_AA10.8_filter2	VLCAD	3	2	0	5
test_AA10.7_filter3	3MCC	5	17	0	22
test_AA10.7_filter3	ARG	1	2	0	3
test_AA10.7_filter3	BKT	0	2	0	2
test_AA10.7_filter3	CIT	11	11	0	22
test_AA10.7_filter3	CPT I	1	0	0	1
test_AA10.7_filter3	CPT II	2	4	0	6
test_AA10.7_filter3	CTD	12	15	2	29
test_AA10.7_filter3	GA-I	13	14	0	27
test_AA10.7_filter3	GA2	3	4	0	7
test_AA10.7_filter3	HCY	3	4	1	8
test_AA10.7_filter3	HYPRO	0	2	0	2
test_AA10.7_filter3	IVA	12	13	2	27
test_AA10.7_filter3	LCHAD	4	3	0	7
test_AA10.7_filter3	MAL	1	5	0	6
test_AA10.7_filter3	MCAD	68	59	1	128
test_AA10.7_filter3	MCD	1	2	0	3
test_AA10.7_filter3	MSUD	5	13	0	18
test_AA10.7_filter3	OTC	6	0	0	6
test_AA10.7_filter3	PA/MMA	41	23	0	64
test_AA10.7_filter3	PKU	50	6	0	56
test_AA10.7_filter3	SCAD	11	39	2	52
test_AA10.7_filter3	TFP	1	2	0	3
test_AA10.7_filter3	TYRO1	5	1	0	6
test_AA10.7_filter3	VLCAD	17	18	0	35
val_AA10.4_filter2	3MCC	14	1	0	15
val_AA10.4_filter2	BKT	1	0	0	1
val_AA10.4_filter2	CIT	4	2	0	6
val_AA10.4_filter2	CTD	9	0	0	9
val_AA10.4_filter2	GA-I	1	0	0	1
val_AA10.4_filter2	GA2	3	1	0	4
val_AA10.4_filter2	HCY	0	1	0	1
val_AA10.4_filter2	IVA	3	0	0	3
val_AA10.4_filter2	MCAD	16	1	0	17
val_AA10.4_filter2	MCD	1	0	0	1
val_AA10.4_filter2	MSUD	1	1	1	3
val_AA10.4_filter2	OTC	4	1	0	5
val_AA10.4_filter2	PA/MMA	8	1	0	9
val_AA10.4_filter2	PKU	37	2	0	39
val_AA10.4_filter2	SCAD	9	8	0	17
val_AA10.4_filter2	TFP	1	0	0	1
val_AA10.4_filter2	VLCAD	4	1	0	5
AA10.6.NonSyn.01_filter4	3MCC	10	14	0	24
AA10.6.NonSyn.01_filter4	ARG	1	0	0	1
AA10.6.NonSyn.01_filter4	BKT	0	2	0	2
AA10.6.NonSyn.01_filter4	CIT	11	7	1	19
AA10.6.NonSyn.01_filter4	CPT II	1	5	0	6
AA10.6.NonSyn.01_filter4	CTD	13	16	4	33
AA10.6.NonSyn.01_filter4	GA-I	15	9	0	24
AA10.6.NonSyn.01_filter4	GA2	5	2	0	7
AA10.6.NonSyn.01_filter4	HCY	3	4	1	8
AA10.6.NonSyn.01_filter4	HYPRO	0	1	0	1
AA10.6.NonSyn.01_filter4	IVA	8	13	1	22
AA10.6.NonSyn.01_filter4	LCHAD	2	3	1	6
AA10.6.NonSyn.01_filter4	MAL	1	2	0	3
AA10.6.NonSyn.01_filter4	MCAD	81	27	1	109
AA10.6.NonSyn.01_filter4	MCD	1	3	0	4
AA10.6.NonSyn.01_filter4	MSUD	7	5	0	12
AA10.6.NonSyn.01_filter4	OTC	6	2	0	8
AA10.6.NonSyn.01_filter4	PA/MMA	16	43	2	61
AA10.6.NonSyn.01_filter4	PKU	31	26	0	57
AA10.6.NonSyn.01_filter4	SCAD	24	20	2	46
AA10.6.NonSyn.01_filter4	TFP	1	3	0	4
AA10.6.NonSyn.01_filter4	TYRO1	3	3	0	6
AA10.6.NonSyn.01_filter4	VLCAD	16	15	0	31
val_AA10.1_filter3	3MCC	11	0	0	11
val_AA10.1_filter3	CIT	3	2	0	5
val_AA10.1_filter3	CTD	9	0	0	9
val_AA10.1_filter3	GA-I	1	0	0	1
val_AA10.1_filter3	GA2	2	0	0	2
val_AA10.1_filter3	HCY	1	0	0	1
val_AA10.1_filter3	IVA	2	0	0	2
val_AA10.1_filter3	MCAD	11	1	0	12
val_AA10.1_filter3	MCD	1	0	0	1
val_AA10.1_filter3	MSUD	1	1	0	2
val_AA10.1_filter3	OTC	3	0	0	3
val_AA10.1_filter3	PA/MMA	9	0	0	9
val_AA10.1_filter3	PKU	32	0	0	32
val_AA10.1_filter3	SCAD	8	7	0	15
val_AA10.1_filter3	TFP	1	0	0	1
val_AA10.1_filter3	VLCAD	4	0	0	4
test_AA10.6.NonSyn.01_batch2	3MCC	6	6	1	13
test_AA10.6.NonSyn.01_batch2	ARG	0	1	1	2
test_AA10.6.NonSyn.01_batch2	CIT	6	2	1	9
test_AA10.6.NonSyn.01_batch2	CPT I	0	1	0	1
test_AA10.6.NonSyn.01_batch2	CPT II	0	1	0	1
test_AA10.6.NonSyn.01_batch2	CTD	6	2	0	8
test_AA10.6.NonSyn.01_batch2	GA-I	5	3	0	8
test_AA10.6.NonSyn.01_batch2	GA2	0	2	0	2
test_AA10.6.NonSyn.01_batch2	HCY	1	0	0	1
test_AA10.6.NonSyn.01_batch2	IVA	10	2	1	13
test_AA10.6.NonSyn.01_batch2	LCHAD	0	1	1	2
test_AA10.6.NonSyn.01_batch2	MAL	0	1	0	1
test_AA10.6.NonSyn.01_batch2	MCAD	32	8	0	40
test_AA10.6.NonSyn.01_batch2	MSUD	2	1	0	3
test_AA10.6.NonSyn.01_batch2	OTC	3	4	0	7
test_AA10.6.NonSyn.01_batch2	PA/MMA	4	9	1	14
test_AA10.6.NonSyn.01_batch2	PKU	27	33	1	61
test_AA10.6.NonSyn.01_batch2	RMD	1	2	0	3
test_AA10.6.NonSyn.01_batch2	SCAD	7	23	1	31
test_AA10.6.NonSyn.01_batch2	TFP	0	1	0	1
test_AA10.6.NonSyn.01_batch2	TYRO1	1	0	0	1
test_AA10.6.NonSyn.01_batch2	VLCAD	2	3	0	5
val_AA10.7_filter1	3MCC	3	12	0	15
val_AA10.7_filter1	BKT	0	1	0	1
val_AA10.7_filter1	CIT	3	3	0	6
val_AA10.7_filter1	CTD	7	2	0	9
val_AA10.7_filter1	GA-I	0	1	0	1
val_AA10.7_filter1	GA2	2	2	0	4
val_AA10.7_filter1	HCY	1	0	0	1
val_AA10.7_filter1	IVA	1	2	0	3
val_AA10.7_filter1	MCAD	5	12	0	17
val_AA10.7_filter1	MCD	0	1	0	1
val_AA10.7_filter1	MSUD	1	2	0	3
val_AA10.7_filter1	OTC	1	4	0	5
val_AA10.7_filter1	PA/MMA	6	3	0	9
val_AA10.7_filter1	PKU	37	2	0	39
val_AA10.7_filter1	SCAD	6	11	0	17
val_AA10.7_filter1	TFP	0	1	0	1
val_AA10.7_filter1	VLCAD	3	2	0	5
val_AA10.6.NonSyn.01_filter3	3MCC	7	4	0	11
val_AA10.6.NonSyn.01_filter3	CIT	2	2	1	5
val_AA10.6.NonSyn.01_filter3	CTD	4	4	1	9
val_AA10.6.NonSyn.01_filter3	GA-I	1	0	0	1
val_AA10.6.NonSyn.01_filter3	GA2	2	0	0	2
val_AA10.6.NonSyn.01_filter3	HCY	0	1	0	1
val_AA10.6.NonSyn.01_filter3	IVA	0	2	0	2
val_AA10.6.NonSyn.01_filter3	MCAD	10	2	0	12
val_AA10.6.NonSyn.01_filter3	MCD	0	1	0	1
val_AA10.6.NonSyn.01_filter3	MSUD	1	1	0	2
val_AA10.6.NonSyn.01_filter3	OTC	2	1	0	3
val_AA10.6.NonSyn.01_filter3	PA/MMA	4	5	0	9
val_AA10.6.NonSyn.01_filter3	PKU	17	15	0	32
val_AA10.6.NonSyn.01_filter3	SCAD	7	8	0	15
val_AA10.6.NonSyn.01_filter3	TFP	0	1	0	1
val_AA10.6.NonSyn.01_filter3	VLCAD	2	2	0	4
test_AA10.7_batch3	3MCC	6	11	0	17
test_AA10.7_batch3	ARG	1	1	0	2
test_AA10.7_batch3	BKT	0	2	0	2
test_AA10.7_batch3	CIT	9	8	0	17
test_AA10.7_batch3	CPT II	3	4	0	7
test_AA10.7_batch3	CTD	12	16	2	30
test_AA10.7_batch3	GA-I	14	12	1	27
test_AA10.7_batch3	GA2	3	3	0	6
test_AA10.7_batch3	HCY	4	5	1	10
test_AA10.7_batch3	HYPRO	0	3	0	3
test_AA10.7_batch3	IVA	10	13	1	24
test_AA10.7_batch3	LCHAD	4	3	0	7
test_AA10.7_batch3	MAL	1	4	0	5
test_AA10.7_batch3	MCAD	63	52	2	117
test_AA10.7_batch3	MCD	1	3	0	4
test_AA10.7_batch3	MSUD	6	13	0	19
test_AA10.7_batch3	OTC	4	0	0	4
test_AA10.7_batch3	PA/MMA	42	25	0	67
test_AA10.7_batch3	PKU	25	6	0	31
test_AA10.7_batch3	SCAD	11	24	1	36
test_AA10.7_batch3	TFP	1	1	0	2
test_AA10.7_batch3	TYRO1	5	1	0	6
test_AA10.7_batch3	VLCAD	19	18	0	37
test_AA10.2_batch2	3MCC	6	6	1	13
test_AA10.2_batch2	ARG	2	0	0	2
test_AA10.2_batch2	CIT	7	2	0	9
test_AA10.2_batch2	CPT I	1	0	0	1
test_AA10.2_batch2	CPT II	0	1	0	1
test_AA10.2_batch2	CTD	7	1	0	8
test_AA10.2_batch2	GA-I	8	0	0	8
test_AA10.2_batch2	GA2	1	1	0	2
test_AA10.2_batch2	HCY	1	0	0	1
test_AA10.2_batch2	IVA	13	0	0	13
test_AA10.2_batch2	LCHAD	2	0	0	2
test_AA10.2_batch2	MAL	0	1	0	1
test_AA10.2_batch2	MCAD	40	0	0	40
test_AA10.2_batch2	MSUD	3	0	0	3
test_AA10.2_batch2	OTC	5	2	0	7
test_AA10.2_batch2	PA/MMA	13	1	0	14
test_AA10.2_batch2	PKU	59	2	0	61
test_AA10.2_batch2	RMD	3	0	0	3
test_AA10.2_batch2	SCAD	9	21	1	31
test_AA10.2_batch2	TFP	1	0	0	1
test_AA10.2_batch2	TYRO1	1	0	0	1
test_AA10.2_batch2	VLCAD	5	0	0	5
AA10.6.NonSyn.005	3MCC	21	23	1	45
AA10.6.NonSyn.005	ARG	1	2	1	4
AA10.6.NonSyn.005	BKT	1	2	0	3
AA10.6.NonSyn.005	CIT	19	12	2	33
AA10.6.NonSyn.005	CPT I	0	1	0	1
AA10.6.NonSyn.005	CPT II	1	7	0	8
AA10.6.NonSyn.005	CTD	22	22	3	47
AA10.6.NonSyn.005	GA-I	24	12	0	36
AA10.6.NonSyn.005	GA2	7	5	0	12
AA10.6.NonSyn.005	HCY	5	5	2	12
AA10.6.NonSyn.005	HYPRO	0	3	0	3
AA10.6.NonSyn.005	IVA	23	15	2	40
AA10.6.NonSyn.005	LCHAD	2	7	0	9
AA10.6.NonSyn.005	MAL	1	5	0	6
AA10.6.NonSyn.005	MCAD	132	41	1	174
AA10.6.NonSyn.005	MCD	1	4	0	5
AA10.6.NonSyn.005	MSUD	13	10	2	25
AA10.6.NonSyn.005	OTC	10	6	0	16
AA10.6.NonSyn.005	PA/MMA	22	66	2	90
AA10.6.NonSyn.005	PKU	65	65	1	131
AA10.6.NonSyn.005	RMD	1	2	0	3
AA10.6.NonSyn.005	SCAD	31	52	1	84
AA10.6.NonSyn.005	TFP	1	3	0	4
AA10.6.NonSyn.005	TYRO1	3	4	0	7
AA10.6.NonSyn.005	VLCAD	25	22	0	47
AA10.6.NonSyn.005_filter2	3MCC	18	22	1	41
AA10.6.NonSyn.005_filter2	ARG	1	1	1	3
AA10.6.NonSyn.005_filter2	BKT	1	2	0	3
AA10.6.NonSyn.005_filter2	CIT	17	10	1	28
AA10.6.NonSyn.005_filter2	CPT I	0	1	0	1
AA10.6.NonSyn.005_filter2	CPT II	1	7	0	8
AA10.6.NonSyn.005_filter2	CTD	19	20	3	42
AA10.6.NonSyn.005_filter2	GA-I	20	11	0	31
AA10.6.NonSyn.005_filter2	GA2	7	4	0	11
AA10.6.NonSyn.005_filter2	HCY	4	4	2	10
AA10.6.NonSyn.005_filter2	HYPRO	0	2	0	2
AA10.6.NonSyn.005_filter2	IVA	17	15	2	34
AA10.6.NonSyn.005_filter2	LCHAD	2	7	0	9
AA10.6.NonSyn.005_filter2	MAL	1	5	0	6
AA10.6.NonSyn.005_filter2	MCAD	117	37	1	155
AA10.6.NonSyn.005_filter2	MCD	1	3	0	4
AA10.6.NonSyn.005_filter2	MSUD	13	10	2	25
AA10.6.NonSyn.005_filter2	OTC	9	5	0	14
AA10.6.NonSyn.005_filter2	PA/MMA	20	57	2	79
AA10.6.NonSyn.005_filter2	PKU	58	56	1	115
AA10.6.NonSyn.005_filter2	RMD	1	0	0	1
AA10.6.NonSyn.005_filter2	SCAD	30	46	1	77
AA10.6.NonSyn.005_filter2	TFP	1	3	0	4
AA10.6.NonSyn.005_filter2	TYRO1	3	3	0	6
AA10.6.NonSyn.005_filter2	VLCAD	21	20	0	41
test_AA10.2_filter4	3MCC	9	4	0	13
test_AA10.2_filter4	ARG	1	0	0	1
test_AA10.2_filter4	BKT	2	0	0	2
test_AA10.2_filter4	CIT	13	1	0	14
test_AA10.2_filter4	CPT II	3	3	0	6
test_AA10.2_filter4	CTD	16	6	2	24
test_AA10.2_filter4	GA-I	20	3	0	23
test_AA10.2_filter4	GA2	5	0	0	5
test_AA10.2_filter4	HCY	5	1	1	7
test_AA10.2_filter4	HYPRO	0	1	0	1
test_AA10.2_filter4	IVA	15	4	1	20
test_AA10.2_filter4	LCHAD	6	0	0	6
test_AA10.2_filter4	MAL	2	1	0	3
test_AA10.2_filter4	MCAD	87	9	1	97
test_AA10.2_filter4	MCD	1	2	0	3
test_AA10.2_filter4	MSUD	9	1	0	10
test_AA10.2_filter4	OTC	5	0	0	5
test_AA10.2_filter4	PA/MMA	40	11	1	52
test_AA10.2_filter4	PKU	21	4	0	25
test_AA10.2_filter4	SCAD	21	9	1	31
test_AA10.2_filter4	TFP	3	0	0	3
test_AA10.2_filter4	TYRO1	6	0	0	6
test_AA10.2_filter4	VLCAD	21	6	0	27
test_AA10.6_batch2	3MCC	6	6	1	13
test_AA10.6_batch2	ARG	2	0	0	2
test_AA10.6_batch2	CIT	7	2	0	9
test_AA10.6_batch2	CPT I	1	0	0	1
test_AA10.6_batch2	CPT II	0	1	0	1
test_AA10.6_batch2	CTD	7	1	0	8
test_AA10.6_batch2	GA-I	8	0	0	8
test_AA10.6_batch2	GA2	1	1	0	2
test_AA10.6_batch2	HCY	1	0	0	1
test_AA10.6_batch2	IVA	13	0	0	13
test_AA10.6_batch2	LCHAD	2	0	0	2
test_AA10.6_batch2	MAL	0	1	0	1
test_AA10.6_batch2	MCAD	39	1	0	40
test_AA10.6_batch2	MSUD	3	0	0	3
test_AA10.6_batch2	OTC	5	2	0	7
test_AA10.6_batch2	PA/MMA	13	1	0	14
test_AA10.6_batch2	PKU	59	2	0	61
test_AA10.6_batch2	RMD	3	0	0	3
test_AA10.6_batch2	SCAD	10	21	0	31
test_AA10.6_batch2	TFP	1	0	0	1
test_AA10.6_batch2	TYRO1	1	0	0	1
test_AA10.6_batch2	VLCAD	5	0	0	5
test_AA10.9.NoOneGene_filter4	3MCC	9	4	0	13
test_AA10.9.NoOneGene_filter4	ARG	1	0	0	1
test_AA10.9.NoOneGene_filter4	BKT	2	0	0	2
test_AA10.9.NoOneGene_filter4	CIT	13	1	0	14
test_AA10.9.NoOneGene_filter4	CPT II	3	3	0	6
test_AA10.9.NoOneGene_filter4	CTD	17	6	1	24
test_AA10.9.NoOneGene_filter4	GA-I	20	3	0	23
test_AA10.9.NoOneGene_filter4	GA2	5	0	0	5
test_AA10.9.NoOneGene_filter4	HCY	5	1	1	7
test_AA10.9.NoOneGene_filter4	HYPRO	0	1	0	1
test_AA10.9.NoOneGene_filter4	IVA	15	4	1	20
test_AA10.9.NoOneGene_filter4	LCHAD	6	0	0	6
test_AA10.9.NoOneGene_filter4	MAL	2	1	0	3
test_AA10.9.NoOneGene_filter4	MCAD	87	9	1	97
test_AA10.9.NoOneGene_filter4	MCD	1	2	0	3
test_AA10.9.NoOneGene_filter4	MSUD	9	1	0	10
test_AA10.9.NoOneGene_filter4	OTC	5	0	0	5
test_AA10.9.NoOneGene_filter4	PA/MMA	40	11	1	52
test_AA10.9.NoOneGene_filter4	PKU	21	4	0	25
test_AA10.9.NoOneGene_filter4	SCAD	21	9	1	31
test_AA10.9.NoOneGene_filter4	TFP	3	0	0	3
test_AA10.9.NoOneGene_filter4	TYRO1	6	0	0	6
test_AA10.9.NoOneGene_filter4	VLCAD	21	6	0	27
AA10.6.NonSyn.02_batch2	3MCC	6	5	2	13
AA10.6.NonSyn.02_batch2	ARG	0	1	1	2
AA10.6.NonSyn.02_batch2	CIT	6	2	1	9
AA10.6.NonSyn.02_batch2	CPT I	0	1	0	1
AA10.6.NonSyn.02_batch2	CPT II	0	1	0	1
AA10.6.NonSyn.02_batch2	CTD	6	2	0	8
AA10.6.NonSyn.02_batch2	GA-I	5	3	0	8
AA10.6.NonSyn.02_batch2	GA2	0	2	0	2
AA10.6.NonSyn.02_batch2	HCY	1	0	0	1
AA10.6.NonSyn.02_batch2	IVA	10	2	1	13
AA10.6.NonSyn.02_batch2	LCHAD	0	1	1	2
AA10.6.NonSyn.02_batch2	MAL	0	1	0	1
AA10.6.NonSyn.02_batch2	MCAD	32	8	0	40
AA10.6.NonSyn.02_batch2	MSUD	2	1	0	3
AA10.6.NonSyn.02_batch2	OTC	3	4	0	7
AA10.6.NonSyn.02_batch2	PA/MMA	4	9	1	14
AA10.6.NonSyn.02_batch2	PKU	27	33	1	61
AA10.6.NonSyn.02_batch2	RMD	1	2	0	3
AA10.6.NonSyn.02_batch2	SCAD	7	22	2	31
AA10.6.NonSyn.02_batch2	TFP	0	1	0	1
AA10.6.NonSyn.02_batch2	TYRO1	1	0	0	1
AA10.6.NonSyn.02_batch2	VLCAD	2	3	0	5
test_AA10.1_batch2	3MCC	6	6	1	13
test_AA10.1_batch2	ARG	2	0	0	2
test_AA10.1_batch2	CIT	7	2	0	9
test_AA10.1_batch2	CPT I	1	0	0	1
test_AA10.1_batch2	CPT II	0	1	0	1
test_AA10.1_batch2	CTD	7	1	0	8
test_AA10.1_batch2	GA-I	8	0	0	8
test_AA10.1_batch2	GA2	1	1	0	2
test_AA10.1_batch2	HCY	1	0	0	1
test_AA10.1_batch2	IVA	13	0	0	13
test_AA10.1_batch2	LCHAD	2	0	0	2
test_AA10.1_batch2	MAL	0	1	0	1
test_AA10.1_batch2	MCAD	40	0	0	40
test_AA10.1_batch2	MSUD	3	0	0	3
test_AA10.1_batch2	OTC	5	2	0	7
test_AA10.1_batch2	PA/MMA	13	1	0	14
test_AA10.1_batch2	PKU	59	2	0	61
test_AA10.1_batch2	RMD	3	0	0	3
test_AA10.1_batch2	SCAD	9	21	1	31
test_AA10.1_batch2	TFP	1	0	0	1
test_AA10.1_batch2	TYRO1	1	0	0	1
test_AA10.1_batch2	VLCAD	5	0	0	5
AA10.6.NonSyn.02_filter1	3MCC	19	21	2	42
AA10.6.NonSyn.02_filter1	ARG	1	1	1	3
AA10.6.NonSyn.02_filter1	BKT	1	2	0	3
AA10.6.NonSyn.02_filter1	CIT	18	10	1	29
AA10.6.NonSyn.02_filter1	CPT I	0	1	0	1
AA10.6.NonSyn.02_filter1	CPT II	1	6	1	8
AA10.6.NonSyn.02_filter1	CTD	20	18	5	43
AA10.6.NonSyn.02_filter1	GA-I	21	10	1	32
AA10.6.NonSyn.02_filter1	GA2	7	4	0	11
AA10.6.NonSyn.02_filter1	HCY	5	4	2	11
AA10.6.NonSyn.02_filter1	HYPRO	0	2	0	2
AA10.6.NonSyn.02_filter1	IVA	19	14	3	36
AA10.6.NonSyn.02_filter1	LCHAD	2	6	1	9
AA10.6.NonSyn.02_filter1	MAL	1	5	0	6
AA10.6.NonSyn.02_filter1	MCAD	120	36	4	160
AA10.6.NonSyn.02_filter1	MCD	1	3	0	4
AA10.6.NonSyn.02_filter1	MSUD	13	10	2	25
AA10.6.NonSyn.02_filter1	OTC	9	5	0	14
AA10.6.NonSyn.02_filter1	PA/MMA	22	56	4	82
AA10.6.NonSyn.02_filter1	PKU	60	56	2	118
AA10.6.NonSyn.02_filter1	RMD	1	0	0	1
AA10.6.NonSyn.02_filter1	SCAD	32	44	4	80
AA10.6.NonSyn.02_filter1	TFP	1	3	0	4
AA10.6.NonSyn.02_filter1	TYRO1	3	4	0	7
AA10.6.NonSyn.02_filter1	VLCAD	23	21	0	44
val_AA10.9.NoOneGene	3MCC	14	1	0	15
val_AA10.9.NoOneGene	BKT	1	0	0	1
val_AA10.9.NoOneGene	CIT	5	2	0	7
val_AA10.9.NoOneGene	CTD	9	0	0	9
val_AA10.9.NoOneGene	GA-I	1	0	0	1
val_AA10.9.NoOneGene	GA2	3	1	0	4
val_AA10.9.NoOneGene	HCY	1	0	0	1
val_AA10.9.NoOneGene	IVA	3	0	0	3
val_AA10.9.NoOneGene	MCAD	16	1	0	17
val_AA10.9.NoOneGene	MCD	1	0	0	1
val_AA10.9.NoOneGene	MSUD	2	1	0	3
val_AA10.9.NoOneGene	OTC	4	1	0	5
val_AA10.9.NoOneGene	PA/MMA	9	0	0	9
val_AA10.9.NoOneGene	PKU	39	0	0	39
val_AA10.9.NoOneGene	SCAD	9	8	0	17
val_AA10.9.NoOneGene	TFP	1	0	0	1
val_AA10.9.NoOneGene	VLCAD	5	0	0	5
test_AA10.8_batch3	3MCC	6	11	0	17
test_AA10.8_batch3	ARG	1	1	0	2
test_AA10.8_batch3	BKT	0	2	0	2
test_AA10.8_batch3	CIT	9	8	0	17
test_AA10.8_batch3	CPT II	3	4	0	7
test_AA10.8_batch3	CTD	13	16	1	30
test_AA10.8_batch3	GA-I	14	12	1	27
test_AA10.8_batch3	GA2	3	3	0	6
test_AA10.8_batch3	HCY	2	7	1	10
test_AA10.8_batch3	HYPRO	0	3	0	3
test_AA10.8_batch3	IVA	10	13	1	24
test_AA10.8_batch3	LCHAD	4	3	0	7
test_AA10.8_batch3	MAL	1	4	0	5
test_AA10.8_batch3	MCAD	61	56	0	117
test_AA10.8_batch3	MCD	1	3	0	4
test_AA10.8_batch3	MSUD	6	13	0	19
test_AA10.8_batch3	OTC	4	0	0	4
test_AA10.8_batch3	PA/MMA	41	26	0	67
test_AA10.8_batch3	PKU	23	8	0	31
test_AA10.8_batch3	SCAD	2	34	0	36
test_AA10.8_batch3	TFP	1	1	0	2
test_AA10.8_batch3	TYRO1	5	1	0	6
test_AA10.8_batch3	VLCAD	19	18	0	37
test_AA10.9.NoOneGene	3MCC	19	10	1	30
test_AA10.9.NoOneGene	ARG	4	0	0	4
test_AA10.9.NoOneGene	BKT	2	0	0	2
test_AA10.9.NoOneGene	CIT	23	3	0	26
test_AA10.9.NoOneGene	CPT I	1	0	0	1
test_AA10.9.NoOneGene	CPT II	5	3	0	8
test_AA10.9.NoOneGene	CTD	28	9	1	38
test_AA10.9.NoOneGene	GA-I	30	4	1	35
test_AA10.9.NoOneGene	GA2	6	2	0	8
test_AA10.9.NoOneGene	HCY	8	2	1	11
test_AA10.9.NoOneGene	HYPRO	0	3	0	3
test_AA10.9.NoOneGene	IVA	31	5	1	37
test_AA10.9.NoOneGene	LCHAD	9	0	0	9
test_AA10.9.NoOneGene	MAL	2	4	0	6
test_AA10.9.NoOneGene	MCAD	146	10	1	157
test_AA10.9.NoOneGene	MCD	1	3	0	4
test_AA10.9.NoOneGene	MSUD	20	2	0	22
test_AA10.9.NoOneGene	OTC	9	2	0	11
test_AA10.9.NoOneGene	PA/MMA	65	15	1	81
test_AA10.9.NoOneGene	PKU	84	8	0	92
test_AA10.9.NoOneGene	RMD	3	0	0	3
test_AA10.9.NoOneGene	SCAD	31	33	3	67
test_AA10.9.NoOneGene	TFP	3	0	0	3
test_AA10.9.NoOneGene	TYRO1	7	0	0	7
test_AA10.9.NoOneGene	VLCAD	36	6	0	42
AA10.3_batch2	3MCC	6	6	1	13
AA10.3_batch2	ARG	2	0	0	2
AA10.3_batch2	CIT	7	2	0	9
AA10.3_batch2	CPT I	1	0	0	1
AA10.3_batch2	CPT II	0	1	0	1
AA10.3_batch2	CTD	7	1	0	8
AA10.3_batch2	GA-I	8	0	0	8
AA10.3_batch2	GA2	1	1	0	2
AA10.3_batch2	HCY	1	0	0	1
AA10.3_batch2	IVA	13	0	0	13
AA10.3_batch2	LCHAD	2	0	0	2
AA10.3_batch2	MAL	0	1	0	1
AA10.3_batch2	MCAD	40	0	0	40
AA10.3_batch2	MSUD	3	0	0	3
AA10.3_batch2	OTC	5	2	0	7
AA10.3_batch2	PA/MMA	13	1	0	14
AA10.3_batch2	PKU	59	2	0	61
AA10.3_batch2	RMD	3	0	0	3
AA10.3_batch2	SCAD	9	21	1	31
AA10.3_batch2	TFP	1	0	0	1
AA10.3_batch2	TYRO1	1	0	0	1
AA10.3_batch2	VLCAD	5	0	0	5
test_AA10.8_filter4	3MCC	3	10	0	13
test_AA10.8_filter4	ARG	0	1	0	1
test_AA10.8_filter4	BKT	0	2	0	2
test_AA10.8_filter4	CIT	8	6	0	14
test_AA10.8_filter4	CPT II	2	4	0	6
test_AA10.8_filter4	CTD	11	12	1	24
test_AA10.8_filter4	GA-I	12	11	0	23
test_AA10.8_filter4	GA2	3	2	0	5
test_AA10.8_filter4	HCY	2	4	1	7
test_AA10.8_filter4	HYPRO	0	1	0	1
test_AA10.8_filter4	IVA	7	12	1	20
test_AA10.8_filter4	LCHAD	3	3	0	6
test_AA10.8_filter4	MAL	1	2	0	3
test_AA10.8_filter4	MCAD	52	45	0	97
test_AA10.8_filter4	MCD	1	2	0	3
test_AA10.8_filter4	MSUD	4	6	0	10
test_AA10.8_filter4	OTC	5	0	0	5
test_AA10.8_filter4	PA/MMA	31	21	0	52
test_AA10.8_filter4	PKU	19	6	0	25
test_AA10.8_filter4	SCAD	2	29	0	31
test_AA10.8_filter4	TFP	1	2	0	3
test_AA10.8_filter4	TYRO1	5	1	0	6
test_AA10.8_filter4	VLCAD	14	13	0	27
AA10.9.NoOneGene_filter2	3MCC	30	10	1	41
AA10.9.NoOneGene_filter2	ARG	3	0	0	3
AA10.9.NoOneGene_filter2	BKT	3	0	0	3
AA10.9.NoOneGene_filter2	CIT	24	4	0	28
AA10.9.NoOneGene_filter2	CPT I	1	0	0	1
AA10.9.NoOneGene_filter2	CPT II	5	3	0	8
AA10.9.NoOneGene_filter2	CTD	34	7	1	42
AA10.9.NoOneGene_filter2	GA-I	27	4	0	31
AA10.9.NoOneGene_filter2	GA2	9	2	0	11
AA10.9.NoOneGene_filter2	HCY	8	1	1	10
AA10.9.NoOneGene_filter2	HYPRO	0	2	0	2
AA10.9.NoOneGene_filter2	IVA	28	5	1	34
AA10.9.NoOneGene_filter2	LCHAD	9	0	0	9
AA10.9.NoOneGene_filter2	MAL	2	4	0	6
AA10.9.NoOneGene_filter2	MCAD	143	11	1	155
AA10.9.NoOneGene_filter2	MCD	2	2	0	4
AA10.9.NoOneGene_filter2	MSUD	22	3	0	25
AA10.9.NoOneGene_filter2	OTC	12	2	0	14
AA10.9.NoOneGene_filter2	PA/MMA	65	13	1	79
AA10.9.NoOneGene_filter2	PKU	110	5	0	115
AA10.9.NoOneGene_filter2	RMD	1	0	0	1
AA10.9.NoOneGene_filter2	SCAD	37	37	3	77
AA10.9.NoOneGene_filter2	TFP	4	0	0	4
AA10.9.NoOneGene_filter2	TYRO1	6	0	0	6
AA10.9.NoOneGene_filter2	VLCAD	35	6	0	41
AA10.3_filter2	3MCC	30	10	1	41
AA10.3_filter2	ARG	3	0	0	3
AA10.3_filter2	BKT	3	0	0	3
AA10.3_filter2	CIT	24	4	0	28
AA10.3_filter2	CPT I	1	0	0	1
AA10.3_filter2	CPT II	5	3	0	8
AA10.3_filter2	CTD	33	7	2	42
AA10.3_filter2	GA-I	27	4	0	31
AA10.3_filter2	GA2	9	2	0	11
AA10.3_filter2	HCY	8	1	1	10
AA10.3_filter2	HYPRO	0	2	0	2
AA10.3_filter2	IVA	25	8	1	34
AA10.3_filter2	LCHAD	9	0	0	9
AA10.3_filter2	MAL	2	4	0	6
AA10.3_filter2	MCAD	142	13	0	155
AA10.3_filter2	MCD	2	2	0	4
AA10.3_filter2	MSUD	21	4	0	25
AA10.3_filter2	OTC	11	3	0	14
AA10.3_filter2	PA/MMA	63	15	1	79
AA10.3_filter2	PKU	110	5	0	115
AA10.3_filter2	RMD	1	0	0	1
AA10.3_filter2	SCAD	37	37	3	77
AA10.3_filter2	TFP	4	0	0	4
AA10.3_filter2	TYRO1	6	0	0	6
AA10.3_filter2	VLCAD	35	6	0	41
test_AA10.3_filter1	3MCC	17	9	1	27
test_AA10.3_filter1	ARG	3	0	0	3
test_AA10.3_filter1	BKT	2	0	0	2
test_AA10.3_filter1	CIT	21	2	0	23
test_AA10.3_filter1	CPT I	1	0	0	1
test_AA10.3_filter1	CPT II	5	3	0	8
test_AA10.3_filter1	CTD	25	7	2	34
test_AA10.3_filter1	GA-I	27	4	0	31
test_AA10.3_filter1	GA2	6	1	0	7
test_AA10.3_filter1	HCY	8	1	1	10
test_AA10.3_filter1	HYPRO	0	2	0	2
test_AA10.3_filter1	IVA	26	6	1	33
test_AA10.3_filter1	LCHAD	9	0	0	9
test_AA10.3_filter1	MAL	2	4	0	6
test_AA10.3_filter1	MCAD	131	12	0	143
test_AA10.3_filter1	MCD	1	2	0	3
test_AA10.3_filter1	MSUD	19	3	0	22
test_AA10.3_filter1	OTC	8	1	0	9
test_AA10.3_filter1	PA/MMA	58	14	1	73
test_AA10.3_filter1	PKU	73	6	0	79
test_AA10.3_filter1	RMD	1	0	0	1
test_AA10.3_filter1	SCAD	31	29	3	63
test_AA10.3_filter1	TFP	3	0	0	3
test_AA10.3_filter1	TYRO1	7	0	0	7
test_AA10.3_filter1	VLCAD	33	6	0	39
AA10.6.NonSyn.01_batch1	3MCC	8	7	0	15
AA10.6.NonSyn.01_batch1	BKT	1	0	0	1
AA10.6.NonSyn.01_batch1	CIT	3	3	1	7
AA10.6.NonSyn.01_batch1	CTD	4	4	1	9
AA10.6.NonSyn.01_batch1	GA-I	1	0	0	1
AA10.6.NonSyn.01_batch1	GA2	3	1	0	4
AA10.6.NonSyn.01_batch1	HCY	0	1	0	1
AA10.6.NonSyn.01_batch1	IVA	1	2	0	3
AA10.6.NonSyn.01_batch1	MCAD	14	3	0	17
AA10.6.NonSyn.01_batch1	MCD	0	1	0	1
AA10.6.NonSyn.01_batch1	MSUD	1	1	1	3
AA10.6.NonSyn.01_batch1	OTC	3	2	0	5
AA10.6.NonSyn.01_batch1	PA/MMA	4	5	0	9
AA10.6.NonSyn.01_batch1	PKU	22	17	0	39
AA10.6.NonSyn.01_batch1	SCAD	8	9	0	17
AA10.6.NonSyn.01_batch1	TFP	0	1	0	1
AA10.6.NonSyn.01_batch1	VLCAD	2	3	0	5
AA10.2_filter2	3MCC	30	10	1	41
AA10.2_filter2	ARG	3	0	0	3
AA10.2_filter2	BKT	3	0	0	3
AA10.2_filter2	CIT	24	4	0	28
AA10.2_filter2	CPT I	1	0	0	1
AA10.2_filter2	CPT II	5	3	0	8
AA10.2_filter2	CTD	33	7	2	42
AA10.2_filter2	GA-I	27	4	0	31
AA10.2_filter2	GA2	9	2	0	11
AA10.2_filter2	HCY	8	1	1	10
AA10.2_filter2	HYPRO	0	2	0	2
AA10.2_filter2	IVA	28	5	1	34
AA10.2_filter2	LCHAD	9	0	0	9
AA10.2_filter2	MAL	2	4	0	6
AA10.2_filter2	MCAD	143	11	1	155
AA10.2_filter2	MCD	2	2	0	4
AA10.2_filter2	MSUD	22	3	0	25
AA10.2_filter2	OTC	12	2	0	14
AA10.2_filter2	PA/MMA	65	13	1	79
AA10.2_filter2	PKU	110	5	0	115
AA10.2_filter2	RMD	1	0	0	1
AA10.2_filter2	SCAD	37	37	3	77
AA10.2_filter2	TFP	4	0	0	4
AA10.2_filter2	TYRO1	6	0	0	6
AA10.2_filter2	VLCAD	35	6	0	41
test_AA10.6_filter2	3MCC	16	9	1	26
test_AA10.6_filter2	ARG	3	0	0	3
test_AA10.6_filter2	BKT	2	0	0	2
test_AA10.6_filter2	CIT	20	2	0	22
test_AA10.6_filter2	CPT I	1	0	0	1
test_AA10.6_filter2	CPT II	5	3	0	8
test_AA10.6_filter2	CTD	23	8	2	33
test_AA10.6_filter2	GA-I	26	4	0	30
test_AA10.6_filter2	GA2	6	1	0	7
test_AA10.6_filter2	HCY	5	2	2	9
test_AA10.6_filter2	HYPRO	0	2	0	2
test_AA10.6_filter2	IVA	24	6	1	31
test_AA10.6_filter2	LCHAD	9	0	0	9
test_AA10.6_filter2	MAL	2	4	0	6
test_AA10.6_filter2	MCAD	122	15	1	138
test_AA10.6_filter2	MCD	1	2	0	3
test_AA10.6_filter2	MSUD	18	3	1	22
test_AA10.6_filter2	OTC	8	1	0	9
test_AA10.6_filter2	PA/MMA	55	14	1	70
test_AA10.6_filter2	PKU	71	5	0	76
test_AA10.6_filter2	RMD	1	0	0	1
test_AA10.6_filter2	SCAD	28	30	2	60
test_AA10.6_filter2	TFP	3	0	0	3
test_AA10.6_filter2	TYRO1	6	0	0	6
test_AA10.6_filter2	VLCAD	28	8	0	36
val_AA10.3_filter2	3MCC	14	1	0	15
val_AA10.3_filter2	BKT	1	0	0	1
val_AA10.3_filter2	CIT	4	2	0	6
val_AA10.3_filter2	CTD	9	0	0	9
val_AA10.3_filter2	GA-I	1	0	0	1
val_AA10.3_filter2	GA2	3	1	0	4
val_AA10.3_filter2	HCY	1	0	0	1
val_AA10.3_filter2	IVA	1	2	0	3
val_AA10.3_filter2	MCAD	16	1	0	17
val_AA10.3_filter2	MCD	1	0	0	1
val_AA10.3_filter2	MSUD	2	1	0	3
val_AA10.3_filter2	OTC	3	2	0	5
val_AA10.3_filter2	PA/MMA	8	1	0	9
val_AA10.3_filter2	PKU	39	0	0	39
val_AA10.3_filter2	SCAD	9	8	0	17
val_AA10.3_filter2	TFP	1	0	0	1
val_AA10.3_filter2	VLCAD	5	0	0	5
test_AA10.4_filter4	3MCC	9	4	0	13
test_AA10.4_filter4	ARG	1	0	0	1
test_AA10.4_filter4	BKT	2	0	0	2
test_AA10.4_filter4	CIT	13	1	0	14
test_AA10.4_filter4	CPT II	3	3	0	6
test_AA10.4_filter4	CTD	15	7	2	24
test_AA10.4_filter4	GA-I	20	3	0	23
test_AA10.4_filter4	GA2	5	0	0	5
test_AA10.4_filter4	HCY	4	2	1	7
test_AA10.4_filter4	HYPRO	0	1	0	1
test_AA10.4_filter4	IVA	15	4	1	20
test_AA10.4_filter4	LCHAD	6	0	0	6
test_AA10.4_filter4	MAL	2	1	0	3
test_AA10.4_filter4	MCAD	83	12	2	97
test_AA10.4_filter4	MCD	1	2	0	3
test_AA10.4_filter4	MSUD	9	1	0	10
test_AA10.4_filter4	OTC	5	0	0	5
test_AA10.4_filter4	PA/MMA	40	11	1	52
test_AA10.4_filter4	PKU	21	4	0	25
test_AA10.4_filter4	SCAD	21	9	1	31
test_AA10.4_filter4	TFP	3	0	0	3
test_AA10.4_filter4	TYRO1	6	0	0	6
test_AA10.4_filter4	VLCAD	19	8	0	27
AA10.4_batch2	3MCC	6	6	1	13
AA10.4_batch2	ARG	2	0	0	2
AA10.4_batch2	CIT	7	2	0	9
AA10.4_batch2	CPT I	1	0	0	1
AA10.4_batch2	CPT II	0	1	0	1
AA10.4_batch2	CTD	7	1	0	8
AA10.4_batch2	GA-I	8	0	0	8
AA10.4_batch2	GA2	1	1	0	2
AA10.4_batch2	HCY	1	0	0	1
AA10.4_batch2	IVA	13	0	0	13
AA10.4_batch2	LCHAD	2	0	0	2
AA10.4_batch2	MAL	0	1	0	1
AA10.4_batch2	MCAD	39	1	0	40
AA10.4_batch2	MSUD	3	0	0	3
AA10.4_batch2	OTC	5	2	0	7
AA10.4_batch2	PA/MMA	13	1	0	14
AA10.4_batch2	PKU	59	2	0	61
AA10.4_batch2	RMD	3	0	0	3
AA10.4_batch2	SCAD	10	21	0	31
AA10.4_batch2	TFP	1	0	0	1
AA10.4_batch2	TYRO1	1	0	0	1
AA10.4_batch2	VLCAD	5	0	0	5
test_AA10.6.NonSyn.02_batch3	3MCC	7	10	0	17
test_AA10.6.NonSyn.02_batch3	ARG	1	1	0	2
test_AA10.6.NonSyn.02_batch3	BKT	0	2	0	2
test_AA10.6.NonSyn.02_batch3	CIT	10	7	0	17
test_AA10.6.NonSyn.02_batch3	CPT II	1	5	1	7
test_AA10.6.NonSyn.02_batch3	CTD	12	14	4	30
test_AA10.6.NonSyn.02_batch3	GA-I	18	8	1	27
test_AA10.6.NonSyn.02_batch3	GA2	4	2	0	6
test_AA10.6.NonSyn.02_batch3	HCY	4	4	2	10
test_AA10.6.NonSyn.02_batch3	HYPRO	0	3	0	3
test_AA10.6.NonSyn.02_batch3	IVA	12	11	1	24
test_AA10.6.NonSyn.02_batch3	LCHAD	2	5	0	7
test_AA10.6.NonSyn.02_batch3	MAL	1	4	0	5
test_AA10.6.NonSyn.02_batch3	MCAD	86	27	4	117
test_AA10.6.NonSyn.02_batch3	MCD	1	3	0	4
test_AA10.6.NonSyn.02_batch3	MSUD	10	8	1	19
test_AA10.6.NonSyn.02_batch3	OTC	4	0	0	4
test_AA10.6.NonSyn.02_batch3	PA/MMA	16	47	4	67
test_AA10.6.NonSyn.02_batch3	PKU	16	14	1	31
test_AA10.6.NonSyn.02_batch3	SCAD	17	16	3	36
test_AA10.6.NonSyn.02_batch3	TFP	1	1	0	2
test_AA10.6.NonSyn.02_batch3	TYRO1	2	4	0	6
test_AA10.6.NonSyn.02_batch3	VLCAD	21	16	0	37
AA10.5_filter4	3MCC	6	18	0	24
AA10.5_filter4	ARG	0	1	0	1
AA10.5_filter4	BKT	0	2	0	2
AA10.5_filter4	CIT	11	8	0	19
AA10.5_filter4	CPT II	2	4	0	6
AA10.5_filter4	CTD	17	14	2	33
AA10.5_filter4	GA-I	12	12	0	24
AA10.5_filter4	GA2	4	3	0	7
AA10.5_filter4	HCY	4	3	1	8
AA10.5_filter4	HYPRO	0	1	0	1
AA10.5_filter4	IVA	10	11	1	22
AA10.5_filter4	LCHAD	3	3	0	6
AA10.5_filter4	MAL	1	2	0	3
AA10.5_filter4	MCAD	57	50	2	109
AA10.5_filter4	MCD	1	3	0	4
AA10.5_filter4	MSUD	5	7	0	12
AA10.5_filter4	OTC	7	1	0	8
AA10.5_filter4	PA/MMA	39	22	0	61
AA10.5_filter4	PKU	51	6	0	57
AA10.5_filter4	SCAD	16	29	1	46
AA10.5_filter4	TFP	1	3	0	4
AA10.5_filter4	TYRO1	5	1	0	6
AA10.5_filter4	VLCAD	16	15	0	31
AA10.3_batch3	3MCC	13	4	0	17
AA10.3_batch3	ARG	2	0	0	2
AA10.3_batch3	BKT	2	0	0	2
AA10.3_batch3	CIT	16	1	0	17
AA10.3_batch3	CPT II	5	2	0	7
AA10.3_batch3	CTD	20	8	2	30
AA10.3_batch3	GA-I	22	4	1	27
AA10.3_batch3	GA2	5	1	0	6
AA10.3_batch3	HCY	7	2	1	10
AA10.3_batch3	HYPRO	0	3	0	3
AA10.3_batch3	IVA	17	6	1	24
AA10.3_batch3	LCHAD	7	0	0	7
AA10.3_batch3	MAL	2	3	0	5
AA10.3_batch3	MCAD	105	12	0	117
AA10.3_batch3	MCD	1	3	0	4
AA10.3_batch3	MSUD	16	3	0	19
AA10.3_batch3	OTC	4	0	0	4
AA10.3_batch3	PA/MMA	51	15	1	67
AA10.3_batch3	PKU	25	6	0	31
AA10.3_batch3	SCAD	22	12	2	36
AA10.3_batch3	TFP	2	0	0	2
AA10.3_batch3	TYRO1	6	0	0	6
AA10.3_batch3	VLCAD	31	6	0	37
test_AA10.6_batch3	3MCC	13	4	0	17
test_AA10.6_batch3	ARG	2	0	0	2
test_AA10.6_batch3	BKT	2	0	0	2
test_AA10.6_batch3	CIT	16	1	0	17
test_AA10.6_batch3	CPT II	5	2	0	7
test_AA10.6_batch3	CTD	19	9	2	30
test_AA10.6_batch3	GA-I	22	4	1	27
test_AA10.6_batch3	GA2	5	1	0	6
test_AA10.6_batch3	HCY	5	3	2	10
test_AA10.6_batch3	HYPRO	0	3	0	3
test_AA10.6_batch3	IVA	17	6	1	24
test_AA10.6_batch3	LCHAD	7	0	0	7
test_AA10.6_batch3	MAL	2	3	0	5
test_AA10.6_batch3	MCAD	101	15	1	117
test_AA10.6_batch3	MCD	1	3	0	4
test_AA10.6_batch3	MSUD	15	3	1	19
test_AA10.6_batch3	OTC	4	0	0	4
test_AA10.6_batch3	PA/MMA	51	15	1	67
test_AA10.6_batch3	PKU	25	6	0	31
test_AA10.6_batch3	SCAD	21	13	2	36
test_AA10.6_batch3	TFP	2	0	0	2
test_AA10.6_batch3	TYRO1	6	0	0	6
test_AA10.6_batch3	VLCAD	29	8	0	37
AA10.5_batch1	3MCC	3	12	0	15
AA10.5_batch1	BKT	0	1	0	1
AA10.5_batch1	CIT	4	3	0	7
AA10.5_batch1	CTD	7	2	0	9
AA10.5_batch1	GA-I	0	1	0	1
AA10.5_batch1	GA2	2	2	0	4
AA10.5_batch1	HCY	1	0	0	1
AA10.5_batch1	IVA	3	0	0	3
AA10.5_batch1	MCAD	5	12	0	17
AA10.5_batch1	MCD	0	1	0	1
AA10.5_batch1	MSUD	1	2	0	3
AA10.5_batch1	OTC	2	3	0	5
AA10.5_batch1	PA/MMA	7	2	0	9
AA10.5_batch1	PKU	37	2	0	39
AA10.5_batch1	SCAD	6	11	0	17
AA10.5_batch1	TFP	0	1	0	1
AA10.5_batch1	VLCAD	3	2	0	5
val_AA10.6.NonSyn.005_filter4	3MCC	7	4	0	11
val_AA10.6.NonSyn.005_filter4	CIT	2	2	1	5
val_AA10.6.NonSyn.005_filter4	CTD	4	4	1	9
val_AA10.6.NonSyn.005_filter4	GA-I	1	0	0	1
val_AA10.6.NonSyn.005_filter4	GA2	2	0	0	2
val_AA10.6.NonSyn.005_filter4	HCY	0	1	0	1
val_AA10.6.NonSyn.005_filter4	IVA	0	2	0	2
val_AA10.6.NonSyn.005_filter4	MCAD	10	2	0	12
val_AA10.6.NonSyn.005_filter4	MCD	0	1	0	1
val_AA10.6.NonSyn.005_filter4	MSUD	1	1	0	2
val_AA10.6.NonSyn.005_filter4	OTC	2	1	0	3
val_AA10.6.NonSyn.005_filter4	PA/MMA	3	6	0	9
val_AA10.6.NonSyn.005_filter4	PKU	17	15	0	32
val_AA10.6.NonSyn.005_filter4	SCAD	7	8	0	15
val_AA10.6.NonSyn.005_filter4	TFP	0	1	0	1
val_AA10.6.NonSyn.005_filter4	VLCAD	2	2	0	4
val_AA10.8	3MCC	3	12	0	15
val_AA10.8	BKT	0	1	0	1
val_AA10.8	CIT	4	3	0	7
val_AA10.8	CTD	5	4	0	9
val_AA10.8	GA-I	0	1	0	1
val_AA10.8	GA2	2	2	0	4
val_AA10.8	HCY	0	1	0	1
val_AA10.8	IVA	1	2	0	3
val_AA10.8	MCAD	5	12	0	17
val_AA10.8	MCD	0	1	0	1
val_AA10.8	MSUD	1	2	0	3
val_AA10.8	OTC	1	4	0	5
val_AA10.8	PA/MMA	5	4	0	9
val_AA10.8	PKU	36	3	0	39
val_AA10.8	SCAD	2	15	0	17
val_AA10.8	TFP	0	1	0	1
val_AA10.8	VLCAD	3	2	0	5
val_AA10.9.NoOneGene_filter2	3MCC	14	1	0	15
val_AA10.9.NoOneGene_filter2	BKT	1	0	0	1
val_AA10.9.NoOneGene_filter2	CIT	4	2	0	6
val_AA10.9.NoOneGene_filter2	CTD	9	0	0	9
val_AA10.9.NoOneGene_filter2	GA-I	1	0	0	1
val_AA10.9.NoOneGene_filter2	GA2	3	1	0	4
val_AA10.9.NoOneGene_filter2	HCY	1	0	0	1
val_AA10.9.NoOneGene_filter2	IVA	3	0	0	3
val_AA10.9.NoOneGene_filter2	MCAD	16	1	0	17
val_AA10.9.NoOneGene_filter2	MCD	1	0	0	1
val_AA10.9.NoOneGene_filter2	MSUD	2	1	0	3
val_AA10.9.NoOneGene_filter2	OTC	4	1	0	5
val_AA10.9.NoOneGene_filter2	PA/MMA	9	0	0	9
val_AA10.9.NoOneGene_filter2	PKU	39	0	0	39
val_AA10.9.NoOneGene_filter2	SCAD	9	8	0	17
val_AA10.9.NoOneGene_filter2	TFP	1	0	0	1
val_AA10.9.NoOneGene_filter2	VLCAD	5	0	0	5
val_AA10.3_batch1	3MCC	14	1	0	15
val_AA10.3_batch1	BKT	1	0	0	1
val_AA10.3_batch1	CIT	5	2	0	7
val_AA10.3_batch1	CTD	9	0	0	9
val_AA10.3_batch1	GA-I	1	0	0	1
val_AA10.3_batch1	GA2	3	1	0	4
val_AA10.3_batch1	HCY	1	0	0	1
val_AA10.3_batch1	IVA	1	2	0	3
val_AA10.3_batch1	MCAD	16	1	0	17
val_AA10.3_batch1	MCD	1	0	0	1
val_AA10.3_batch1	MSUD	2	1	0	3
val_AA10.3_batch1	OTC	3	2	0	5
val_AA10.3_batch1	PA/MMA	8	1	0	9
val_AA10.3_batch1	PKU	39	0	0	39
val_AA10.3_batch1	SCAD	9	8	0	17
val_AA10.3_batch1	TFP	1	0	0	1
val_AA10.3_batch1	VLCAD	5	0	0	5
AA10.7_filter1	3MCC	10	32	0	42
AA10.7_filter1	ARG	1	2	0	3
AA10.7_filter1	BKT	0	3	0	3
AA10.7_filter1	CIT	15	14	0	29
AA10.7_filter1	CPT I	1	0	0	1
AA10.7_filter1	CPT II	3	5	0	8
AA10.7_filter1	CTD	23	18	2	43
AA10.7_filter1	GA-I	17	15	0	32
AA10.7_filter1	GA2	5	6	0	11
AA10.7_filter1	HCY	5	5	1	11
AA10.7_filter1	HYPRO	0	2	0	2
AA10.7_filter1	IVA	15	19	2	36
AA10.7_filter1	LCHAD	5	4	0	9
AA10.7_filter1	MAL	1	5	0	6
AA10.7_filter1	MCAD	84	74	2	160
AA10.7_filter1	MCD	1	3	0	4
AA10.7_filter1	MSUD	9	16	0	25
AA10.7_filter1	OTC	8	6	0	14
AA10.7_filter1	PA/MMA	54	28	0	82
AA10.7_filter1	PKU	109	9	0	118
AA10.7_filter1	RMD	1	0	0	1
AA10.7_filter1	SCAD	21	57	2	80
AA10.7_filter1	TFP	1	3	0	4
AA10.7_filter1	TYRO1	6	1	0	7
AA10.7_filter1	VLCAD	21	23	0	44
AA10.7_filter4	3MCC	6	18	0	24
AA10.7_filter4	ARG	0	1	0	1
AA10.7_filter4	BKT	0	2	0	2
AA10.7_filter4	CIT	11	8	0	19
AA10.7_filter4	CPT II	2	4	0	6
AA10.7_filter4	CTD	17	14	2	33
AA10.7_filter4	GA-I	12	12	0	24
AA10.7_filter4	GA2	4	3	0	7
AA10.7_filter4	HCY	4	3	1	8
AA10.7_filter4	HYPRO	0	1	0	1
AA10.7_filter4	IVA	7	14	1	22
AA10.7_filter4	LCHAD	3	3	0	6
AA10.7_filter4	MAL	1	2	0	3
AA10.7_filter4	MCAD	57	51	1	109
AA10.7_filter4	MCD	1	3	0	4
AA10.7_filter4	MSUD	4	8	0	12
AA10.7_filter4	OTC	6	2	0	8
AA10.7_filter4	PA/MMA	38	23	0	61
AA10.7_filter4	PKU	51	6	0	57
AA10.7_filter4	SCAD	16	29	1	46
AA10.7_filter4	TFP	1	3	0	4
AA10.7_filter4	TYRO1	5	1	0	6
AA10.7_filter4	VLCAD	16	15	0	31
AA10.7_batch3	3MCC	6	11	0	17
AA10.7_batch3	ARG	1	1	0	2
AA10.7_batch3	BKT	0	2	0	2
AA10.7_batch3	CIT	9	8	0	17
AA10.7_batch3	CPT II	3	4	0	7
AA10.7_batch3	CTD	12	16	2	30
AA10.7_batch3	GA-I	14	12	1	27
AA10.7_batch3	GA2	3	3	0	6
AA10.7_batch3	HCY	4	5	1	10
AA10.7_batch3	HYPRO	0	3	0	3
AA10.7_batch3	IVA	10	13	1	24
AA10.7_batch3	LCHAD	4	3	0	7
AA10.7_batch3	MAL	1	4	0	5
AA10.7_batch3	MCAD	63	52	2	117
AA10.7_batch3	MCD	1	3	0	4
AA10.7_batch3	MSUD	6	13	0	19
AA10.7_batch3	OTC	4	0	0	4
AA10.7_batch3	PA/MMA	42	25	0	67
AA10.7_batch3	PKU	25	6	0	31
AA10.7_batch3	SCAD	11	24	1	36
AA10.7_batch3	TFP	1	1	0	2
AA10.7_batch3	TYRO1	5	1	0	6
AA10.7_batch3	VLCAD	19	18	0	37
AA10.9.NoOneGene_batch2	3MCC	6	6	1	13
AA10.9.NoOneGene_batch2	ARG	2	0	0	2
AA10.9.NoOneGene_batch2	CIT	7	2	0	9
AA10.9.NoOneGene_batch2	CPT I	1	0	0	1
AA10.9.NoOneGene_batch2	CPT II	0	1	0	1
AA10.9.NoOneGene_batch2	CTD	7	1	0	8
AA10.9.NoOneGene_batch2	GA-I	8	0	0	8
AA10.9.NoOneGene_batch2	GA2	1	1	0	2
AA10.9.NoOneGene_batch2	HCY	1	0	0	1
AA10.9.NoOneGene_batch2	IVA	13	0	0	13
AA10.9.NoOneGene_batch2	LCHAD	2	0	0	2
AA10.9.NoOneGene_batch2	MAL	0	1	0	1
AA10.9.NoOneGene_batch2	MCAD	40	0	0	40
AA10.9.NoOneGene_batch2	MSUD	3	0	0	3
AA10.9.NoOneGene_batch2	OTC	5	2	0	7
AA10.9.NoOneGene_batch2	PA/MMA	13	1	0	14
AA10.9.NoOneGene_batch2	PKU	59	2	0	61
AA10.9.NoOneGene_batch2	RMD	3	0	0	3
AA10.9.NoOneGene_batch2	SCAD	9	21	1	31
AA10.9.NoOneGene_batch2	TFP	1	0	0	1
AA10.9.NoOneGene_batch2	TYRO1	1	0	0	1
AA10.9.NoOneGene_batch2	VLCAD	5	0	0	5
test_AA10.5_filter2	3MCC	6	20	0	26
test_AA10.5_filter2	ARG	1	2	0	3
test_AA10.5_filter2	BKT	0	2	0	2
test_AA10.5_filter2	CIT	11	11	0	22
test_AA10.5_filter2	CPT I	1	0	0	1
test_AA10.5_filter2	CPT II	3	5	0	8
test_AA10.5_filter2	CTD	15	16	2	33
test_AA10.5_filter2	GA-I	16	14	0	30
test_AA10.5_filter2	GA2	3	4	0	7
test_AA10.5_filter2	HCY	4	4	1	9
test_AA10.5_filter2	HYPRO	0	2	0	2
test_AA10.5_filter2	IVA	13	16	2	31
test_AA10.5_filter2	LCHAD	5	4	0	9
test_AA10.5_filter2	MAL	1	5	0	6
test_AA10.5_filter2	MCAD	76	59	3	138
test_AA10.5_filter2	MCD	1	2	0	3
test_AA10.5_filter2	MSUD	10	12	0	22
test_AA10.5_filter2	OTC	7	2	0	9
test_AA10.5_filter2	PA/MMA	47	23	0	70
test_AA10.5_filter2	PKU	70	6	0	76
test_AA10.5_filter2	RMD	1	0	0	1
test_AA10.5_filter2	SCAD	14	44	2	60
test_AA10.5_filter2	TFP	1	2	0	3
test_AA10.5_filter2	TYRO1	5	1	0	6
test_AA10.5_filter2	VLCAD	18	18	0	36
AA10.6.NonSyn.02_batch1	3MCC	8	7	0	15
AA10.6.NonSyn.02_batch1	BKT	1	0	0	1
AA10.6.NonSyn.02_batch1	CIT	3	3	1	7
AA10.6.NonSyn.02_batch1	CTD	4	4	1	9
AA10.6.NonSyn.02_batch1	GA-I	1	0	0	1
AA10.6.NonSyn.02_batch1	GA2	3	1	0	4
AA10.6.NonSyn.02_batch1	HCY	0	1	0	1
AA10.6.NonSyn.02_batch1	IVA	1	1	1	3
AA10.6.NonSyn.02_batch1	MCAD	14	3	0	17
AA10.6.NonSyn.02_batch1	MCD	0	1	0	1
AA10.6.NonSyn.02_batch1	MSUD	1	1	1	3
AA10.6.NonSyn.02_batch1	OTC	3	2	0	5
AA10.6.NonSyn.02_batch1	PA/MMA	4	5	0	9
AA10.6.NonSyn.02_batch1	PKU	22	16	1	39
AA10.6.NonSyn.02_batch1	SCAD	8	9	0	17
AA10.6.NonSyn.02_batch1	TFP	0	1	0	1
AA10.6.NonSyn.02_batch1	VLCAD	2	3	0	5
val_AA10.5_batch1	3MCC	3	12	0	15
val_AA10.5_batch1	BKT	0	1	0	1
val_AA10.5_batch1	CIT	4	3	0	7
val_AA10.5_batch1	CTD	7	2	0	9
val_AA10.5_batch1	GA-I	0	1	0	1
val_AA10.5_batch1	GA2	2	2	0	4
val_AA10.5_batch1	HCY	1	0	0	1
val_AA10.5_batch1	IVA	3	0	0	3
val_AA10.5_batch1	MCAD	5	12	0	17
val_AA10.5_batch1	MCD	0	1	0	1
val_AA10.5_batch1	MSUD	1	2	0	3
val_AA10.5_batch1	OTC	2	3	0	5
val_AA10.5_batch1	PA/MMA	7	2	0	9
val_AA10.5_batch1	PKU	37	2	0	39
val_AA10.5_batch1	SCAD	6	11	0	17
val_AA10.5_batch1	TFP	0	1	0	1
val_AA10.5_batch1	VLCAD	3	2	0	5
AA10.8_batch2	3MCC	2	11	0	13
AA10.8_batch2	ARG	1	1	0	2
AA10.8_batch2	CIT	5	4	0	9
AA10.8_batch2	CPT I	1	0	0	1
AA10.8_batch2	CPT II	0	1	0	1
AA10.8_batch2	CTD	2	6	0	8
AA10.8_batch2	GA-I	6	2	0	8
AA10.8_batch2	GA2	0	2	0	2
AA10.8_batch2	HCY	0	1	0	1
AA10.8_batch2	IVA	7	6	0	13
AA10.8_batch2	LCHAD	1	1	0	2
AA10.8_batch2	MAL	0	1	0	1
AA10.8_batch2	MCAD	23	17	0	40
AA10.8_batch2	MSUD	2	1	0	3
AA10.8_batch2	OTC	3	4	0	7
AA10.8_batch2	PA/MMA	11	3	0	14
AA10.8_batch2	PKU	58	3	0	61
AA10.8_batch2	RMD	3	0	0	3
AA10.8_batch2	SCAD	4	27	0	31
AA10.8_batch2	TFP	0	1	0	1
AA10.8_batch2	TYRO1	1	0	0	1
AA10.8_batch2	VLCAD	1	4	0	5
test_AA10.6	3MCC	19	10	1	30
test_AA10.6	ARG	4	0	0	4
test_AA10.6	BKT	2	0	0	2
test_AA10.6	CIT	23	3	0	26
test_AA10.6	CPT I	1	0	0	1
test_AA10.6	CPT II	5	3	0	8
test_AA10.6	CTD	26	10	2	38
test_AA10.6	GA-I	30	4	1	35
test_AA10.6	GA2	6	2	0	8
test_AA10.6	HCY	6	3	2	11
test_AA10.6	HYPRO	0	3	0	3
test_AA10.6	IVA	30	6	1	37
test_AA10.6	LCHAD	9	0	0	9
test_AA10.6	MAL	2	4	0	6
test_AA10.6	MCAD	140	16	1	157
test_AA10.6	MCD	1	3	0	4
test_AA10.6	MSUD	18	3	1	22
test_AA10.6	OTC	9	2	0	11
test_AA10.6	PA/MMA	64	16	1	81
test_AA10.6	PKU	84	8	0	92
test_AA10.6	RMD	3	0	0	3
test_AA10.6	SCAD	31	34	2	67
test_AA10.6	TFP	3	0	0	3
test_AA10.6	TYRO1	7	0	0	7
test_AA10.6	VLCAD	34	8	0	42
val_AA10.1_filter4	3MCC	11	0	0	11
val_AA10.1_filter4	CIT	3	2	0	5
val_AA10.1_filter4	CTD	9	0	0	9
val_AA10.1_filter4	GA-I	1	0	0	1
val_AA10.1_filter4	GA2	2	0	0	2
val_AA10.1_filter4	HCY	1	0	0	1
val_AA10.1_filter4	IVA	2	0	0	2
val_AA10.1_filter4	MCAD	11	1	0	12
val_AA10.1_filter4	MCD	1	0	0	1
val_AA10.1_filter4	MSUD	1	1	0	2
val_AA10.1_filter4	OTC	3	0	0	3
val_AA10.1_filter4	PA/MMA	9	0	0	9
val_AA10.1_filter4	PKU	32	0	0	32
val_AA10.1_filter4	SCAD	8	7	0	15
val_AA10.1_filter4	TFP	1	0	0	1
val_AA10.1_filter4	VLCAD	4	0	0	4
val_AA10.6.NonSyn.01_filter4	3MCC	7	4	0	11
val_AA10.6.NonSyn.01_filter4	CIT	2	2	1	5
val_AA10.6.NonSyn.01_filter4	CTD	4	4	1	9
val_AA10.6.NonSyn.01_filter4	GA-I	1	0	0	1
val_AA10.6.NonSyn.01_filter4	GA2	2	0	0	2
val_AA10.6.NonSyn.01_filter4	HCY	0	1	0	1
val_AA10.6.NonSyn.01_filter4	IVA	0	2	0	2
val_AA10.6.NonSyn.01_filter4	MCAD	10	2	0	12
val_AA10.6.NonSyn.01_filter4	MCD	0	1	0	1
val_AA10.6.NonSyn.01_filter4	MSUD	1	1	0	2
val_AA10.6.NonSyn.01_filter4	OTC	2	1	0	3
val_AA10.6.NonSyn.01_filter4	PA/MMA	4	5	0	9
val_AA10.6.NonSyn.01_filter4	PKU	17	15	0	32
val_AA10.6.NonSyn.01_filter4	SCAD	7	8	0	15
val_AA10.6.NonSyn.01_filter4	TFP	0	1	0	1
val_AA10.6.NonSyn.01_filter4	VLCAD	2	2	0	4
AA10.6	3MCC	33	11	1	45
AA10.6	ARG	4	0	0	4
AA10.6	BKT	3	0	0	3
AA10.6	CIT	28	5	0	33
AA10.6	CPT I	1	0	0	1
AA10.6	CPT II	5	3	0	8
AA10.6	CTD	35	10	2	47
AA10.6	GA-I	31	4	1	36
AA10.6	GA2	9	3	0	12
AA10.6	HCY	6	4	2	12
AA10.6	HYPRO	0	3	0	3
AA10.6	IVA	31	8	1	40
AA10.6	LCHAD	9	0	0	9
AA10.6	MAL	2	4	0	6
AA10.6	MCAD	156	17	1	174
AA10.6	MCD	2	3	0	5
AA10.6	MSUD	19	4	2	25
AA10.6	OTC	12	4	0	16
AA10.6	PA/MMA	71	18	1	90
AA10.6	PKU	121	10	0	131
AA10.6	RMD	3	0	0	3
AA10.6	SCAD	40	42	2	84
AA10.6	TFP	4	0	0	4
AA10.6	TYRO1	7	0	0	7
AA10.6	VLCAD	38	9	0	47
val_AA10.5_filter4	3MCC	3	8	0	11
val_AA10.5_filter4	CIT	3	2	0	5
val_AA10.5_filter4	CTD	7	2	0	9
val_AA10.5_filter4	GA-I	0	1	0	1
val_AA10.5_filter4	GA2	1	1	0	2
val_AA10.5_filter4	HCY	1	0	0	1
val_AA10.5_filter4	IVA	2	0	0	2
val_AA10.5_filter4	MCAD	4	8	0	12
val_AA10.5_filter4	MCD	0	1	0	1
val_AA10.5_filter4	MSUD	0	2	0	2
val_AA10.5_filter4	OTC	2	1	0	3
val_AA10.5_filter4	PA/MMA	7	2	0	9
val_AA10.5_filter4	PKU	30	2	0	32
val_AA10.5_filter4	SCAD	5	10	0	15
val_AA10.5_filter4	TFP	0	1	0	1
val_AA10.5_filter4	VLCAD	2	2	0	4
